,Client_Name,ID,Date_ID,Account_ID,Transaction_Type,Transfer_Acct_Nbr,ACH_Acct_Nbr,ACH_Rtg_Nbr,Transaction_Purpose,Transaction_Description,Transaction_Amount,Balance
0,Robert King,1,1,29,ACH,,,,Bills & utilities,BILL PAY AUTO DEBIT PG&E SAN FRANCISCO UTILITY BILL,-320.5,99679.5
1,Robert King,2,1,29,Transfer,,,,Investment,ONLINE TRANSFER TO HEDGE FUND A INVESTMENT ACCOUNT,-50000.0,49679.5
2,Robert King,3,2,29,Debit Card,,,,Food & drink,POS PURCHASE #4567 WHOLE FOODS MARKET SF,-45.75,49633.8
3,Robert King,4,3,29,ACH,,,,Employment,ACH DEPOSIT HEDGE FUND A PAYROLL ROBERT KING,250000.0,299634.0
4,Robert King,5,3,29,Debit Card,,,,Entertainment,POS PURCHASE #7890 SF SYMPHONY TICKETS,-120.0,299514.0
5,Robert King,6,4,29,Transfer,,,,Loan,ONLINE TRANSFER TO MORTGAGE PAYMENT,-25000.0,274514.0
6,Robert King,7,4,29,Zelle,,,,Personal,ZELLE PAYMENT TO ALICE KING ALLOWANCE,-200.0,274314.0
7,Robert King,8,5,29,Debit Card,,,,Gas,POS PURCHASE #9876 CHEVRON SF,-75.0,274239.0
8,Robert King,9,5,29,Debit Card,,,,Shopping,POS PURCHASE #1234 APPLE STORE SF,-450.0,273789.0
9,Robert King,10,6,29,ACH,,,,Benefits,ACH CREDIT HEDGE FUND A HEALTH INSURANCE REIMBURSEMENT,1500.0,275289.0
10,Robert King,11,6,29,Debit Card,,,,Health & Wellness,POS PURCHASE #2468 24 HOUR FITNESS MEMBERSHIP SF,-350.0,274939.0
11,Robert King,12,7,29,Check,,,,Tax,CHECK #56789 PAYMENT TO IRS 2023 Q3 ESTIMATED TAX,-15000.0,259939.0
12,Robert King,13,8,29,Transfer,,,,Investment,ONLINE TRANSFER TO TECH STARTUP XYZ SERIES B INVESTMENT,-75000.0,184939.0
13,Robert King,14,9,29,Debit Card,,,,Food & drink,POS PURCHASE #2034 STARBUCKS SF,-30.0,184909.0
14,Robert King,15,9,29,Debit Card,,,,Travel,POS PURCHASE #4567 UNITED AIRLINES FLIGHT BOOKING,-500.0,184409.0
15,Robert King,16,10,29,ACH,,,,Professional Services,ACH DEBIT LEGAL FEES FOR HEDGE FUND A CONSULTATION,-10000.0,174409.0
16,Robert King,17,11,29,Debit Card,,,,Grocieries,POS PURCHASE #6789 SAFEWAY GROCERIES SF,-210.0,174199.0
17,Robert King,18,12,29,Debit Card,,,,Entertainment,POS PURCHASE #7890 SF MUSEUM OF MODERN ART GALA TICKET,-300.0,173899.0
18,Robert King,19,13,29,Transfer,,,,Personal,ONLINE TRANSFER TO TECH COMPANY X BOARD MEETING EXPENSES,-1500.0,172399.0
19,Robert King,20,14,29,Debit Card,,,,Shopping,POS PURCHASE #1234 NIEMAN MARCUS SF,-1200.0,171199.0
20,Robert King,21,15,29,ACH,,,,Bills & utilities,BILL PAY AUTO DEBIT COMCAST SAN FRANCISCO UTILITY BILL,-250.0,170949.0
21,Robert King,22,16,29,Debit Card,,,,Food & drink,POS PURCHASE #2034 MICHAEL MINA RESTAURANT SF,-85.0,170864.0
22,Robert King,23,17,29,Transfer,,,,Investment,ONLINE TRANSFER TO VANGUARD INDEX FUND INVESTMENT,-100000.0,70863.8
23,Robert King,24,18,29,Debit Card,,,,Travel,POS PURCHASE #4567 DELTA AIRLINES BUSINESS CLASS UPGRADE,-3000.0,67863.8
24,Robert King,25,19,29,Debit Card,,,,Health & Wellness,POS PURCHASE #2468 EQUINOX GYM MEMBERSHIP SF,-500.0,67363.8
25,Robert King,26,20,29,ACH,,,,Employment,ACH DEPOSIT HEDGE FUND A PAYROLL ROBERT KING,250000.0,317364.0
26,Robert King,27,21,29,Debit Card,,,,Shopping,POS PURCHASE #1234 BLOOMINGDALE'S SF,-750.0,316614.0
27,Robert King,28,22,29,Debit Card,,,,Food & drink,POS PURCHASE #2034 BLUE BOTTLE COFFEE SF,-60.0,316554.0
28,Robert King,29,23,29,Debit Card,,,,Entertainment,POS PURCHASE #7890 SF JAZZ CENTER TICKETS,-180.0,316374.0
29,Robert King,30,24,29,Transfer,,,,Loan,ONLINE TRANSFER TO MORTGAGE PAYMENT,-25000.0,291374.0
30,Robert King,31,25,29,Debit Card,,,,Gas,POS PURCHASE #9876 SHELL GAS STATION SF,-80.0,291294.0
31,Robert King,32,26,29,Debit Card,,,,Shopping,POS PURCHASE #1234 GUCCI STORE SF,-650.0,290644.0
32,Robert King,33,27,29,ACH,,,,Benefits,ACH CREDIT HEDGE FUND A HEALTH INSURANCE REIMBURSEMENT,1500.0,292144.0
33,Robert King,34,28,29,Debit Card,,,,Health & Wellness,POS PURCHASE #2468 SOULCYCLE CLASS PACKAGE SF,-250.0,291894.0
34,Robert King,35,29,29,Transfer,,,,Investment,ONLINE TRANSFER TO HEDGE FUND A INVESTMENT ACCOUNT,-50000.0,241894.0
35,Robert King,36,30,29,Debit Card,,,,Food & drink,POS PURCHASE #2034 PHILZ COFFEE SF,-40.0,241854.0
36,Robert King,37,31,29,Debit Card,,,,Travel,POS PURCHASE #4567 HILTON HOTEL BOOKING SF,-700.0,241154.0
37,Robert King,38,32,29,ACH,,,,Bills & utilities,BILL PAY AUTO DEBIT PG&E SAN FRANCISCO UTILITY BILL,-320.5,240833.0
38,Robert King,39,33,29,Debit Card,,,,Food & drink,POS PURCHASE #4567 WHOLE FOODS MARKET SF,-50.0,240783.0
39,Robert King,40,34,29,ACH,,,,Employment,ACH DEPOSIT HEDGE FUND A PAYROLL ROBERT KING,250000.0,490783.0
40,Robert King,41,35,29,Debit Card,,,,Entertainment,POS PURCHASE #7890 SF OPERA TICKETS,-150.0,490633.0
41,Robert King,42,36,29,Transfer,,,,Loan,ONLINE TRANSFER TO MORTGAGE PAYMENT,-25000.0,465633.0
42,Robert King,43,37,29,Zelle,,,,Personal,ZELLE PAYMENT TO ALICE KING ALLOWANCE,-200.0,465433.0
43,Robert King,44,38,29,Debit Card,,,,Gas,POS PURCHASE #9876 TEXACO GAS STATION SF,-78.0,465355.0
44,Robert King,45,39,29,Debit Card,,,,Shopping,POS PURCHASE #1234 BEST BUY SF,-520.0,464835.0
45,Robert King,46,40,29,ACH,,,,Benefits,ACH CREDIT HEDGE FUND A HEALTH INSURANCE REIMBURSEMENT,1500.0,466335.0
46,Robert King,47,41,29,Debit Card,,,,Health & Wellness,POS PURCHASE #2468 COREPOWER YOGA MEMBERSHIP SF,-380.0,465955.0
47,Robert King,48,42,29,Check,,,,Tax,CHECK #67890 PAYMENT TO CA FRANCHISE TAX BOARD 2023 Q3 ESTIMATED TAX,-15000.0,450955.0
48,Robert King,49,43,29,Transfer,,,,Investment,ONLINE TRANSFER TO TECH STARTUP XYZ SERIES B INVESTMENT,-80000.0,370955.0
49,Robert King,50,44,29,Debit Card,,,,Food & drink,POS PURCHASE #2034 STARBUCKS SF,-35.0,370920.0
50,Robert King,51,45,29,Debit Card,,,,Travel,POS PURCHASE #4567 AMERICAN AIRLINES FLIGHT BOOKING,-550.0,370370.0
51,Robert King,52,46,29,ACH,,,,Professional Services,ACH DEBIT CONSULTING FEES FOR HEDGE FUND A STRATEGY SESSION,-12000.0,358370.0
52,Robert King,53,47,29,Debit Card,,,,Grocieries,POS PURCHASE #6789 TRADER JOE'S GROCERIES SF,-220.0,358150.0
53,Robert King,54,48,29,Debit Card,,,,Entertainment,POS PURCHASE #7890 SF BALLET TICKETS,-320.0,357830.0
54,Robert King,55,49,29,Transfer,,,,Personal,ONLINE TRANSFER TO TECH COMPANY X BOARD MEETING EXPENSES,-1800.0,356030.0
55,Robert King,56,50,29,Debit Card,,,,Shopping,POS PURCHASE #1234 SAKS FIFTH AVENUE SF,-1300.0,354730.0
56,Robert King,57,51,29,ACH,,,,Bills & utilities,BILL PAY AUTO DEBIT COMCAST SAN FRANCISCO UTILITY BILL,-250.0,354480.0
57,Robert King,58,52,29,Debit Card,,,,Food & drink,POS PURCHASE #2034 THE SLANTED DOOR RESTAURANT SF,-90.0,354390.0
58,Robert King,59,53,29,Transfer,,,,Investment,ONLINE TRANSFER TO VANGUARD INDEX FUND INVESTMENT,-110000.0,244390.0
59,Robert King,60,54,29,Debit Card,,,,Travel,POS PURCHASE #4567 VIRGIN ATLANTIC FIRST CLASS UPGRADE,-3200.0,241190.0
60,Robert King,61,55,29,Debit Card,,,,Health & Wellness,POS PURCHASE #2468 BARRY'S BOOTCAMP PACKAGE SF,-520.0,240670.0
61,Robert King,62,56,29,ACH,,,,Employment,ACH DEPOSIT HEDGE FUND A PAYROLL ROBERT KING,250000.0,490670.0
62,Robert King,63,57,29,Debit Card,,,,Shopping,POS PURCHASE #1234 MACY'S SF,-800.0,489870.0
63,Robert King,64,58,29,Debit Card,,,,Food & drink,POS PURCHASE #2034 PEET'S COFFEE SF,-65.0,489805.0
64,Robert King,65,59,29,Debit Card,,,,Entertainment,POS PURCHASE #7890 SF JAZZ FESTIVAL TICKETS,-190.0,489615.0
65,Robert King,66,60,29,Transfer,,,,Loan,ONLINE TRANSFER TO MORTGAGE PAYMENT,-25000.0,464615.0
66,Robert King,67,61,29,Debit Card,,,,Gas,POS PURCHASE #9876 BP GAS STATION SF,-82.0,464533.0
67,Robert King,68,62,29,ACH,,,,Bills & utilities,BILL PAY AUTO DEBIT PG&E SAN FRANCISCO UTILITY BILL,-320.5,464213.0
68,Robert King,69,63,29,Debit Card,,,,Food & drink,POS PURCHASE #4567 WHOLE FOODS MARKET SF,-55.0,464158.0
69,Robert King,70,64,29,ACH,,,,Employment,ACH DEPOSIT HEDGE FUND A PAYROLL ROBERT KING,250000.0,714158.0
70,Robert King,71,65,29,Debit Card,,,,Entertainment,POS PURCHASE #7890 SF FILM FESTIVAL TICKETS,-160.0,713998.0
71,Robert King,72,66,29,Transfer,,,,Loan,ONLINE TRANSFER TO MORTGAGE PAYMENT,-25000.0,688998.0
72,Robert King,73,67,29,Zelle,,,,Personal,ZELLE PAYMENT TO ALICE KING ALLOWANCE,-200.0,688798.0
73,Robert King,74,68,29,Debit Card,,,,Gas,POS PURCHASE #9876 76 GAS STATION SF,-81.0,688717.0
74,Robert King,75,69,29,Debit Card,,,,Shopping,POS PURCHASE #1234 TARGET SF,-540.0,688177.0
75,Robert King,76,70,29,ACH,,,,Benefits,ACH CREDIT HEDGE FUND A HEALTH INSURANCE REIMBURSEMENT,1500.0,689677.0
76,Robert King,77,71,29,Debit Card,,,,Health & Wellness,POS PURCHASE #2468 PILATES STUDIO MEMBERSHIP SF,-390.0,689287.0
77,Robert King,78,72,29,Check,,,,Tax,CHECK #78901 PAYMENT TO IRS 2023 Q4 ESTIMATED TAX,-15000.0,674287.0
78,Robert King,79,73,29,Transfer,,,,Investment,ONLINE TRANSFER TO TECH STARTUP XYZ SERIES B INVESTMENT,-85000.0,589287.0
79,Robert King,80,74,29,Debit Card,,,,Food & drink,POS PURCHASE #2034 STARBUCKS SF,-40.0,589247.0
80,Robert King,81,75,29,Debit Card,,,,Travel,POS PURCHASE #4567 SOUTHWEST AIRLINES FLIGHT BOOKING,-600.0,588647.0
81,Robert King,82,76,29,ACH,,,,Professional Services,ACH DEBIT MANAGEMENT CONSULTING FEES FOR HEDGE FUND A,-13000.0,575647.0
82,Robert King,83,77,29,Debit Card,,,,Grocieries,POS PURCHASE #6789 COSTCO WHOLESALE SF,-230.0,575417.0
83,Robert King,84,78,29,Debit Card,,,,Entertainment,POS PURCHASE #7890 SF OPERA GALA EVENT,-340.0,575077.0
84,Robert King,85,79,29,Transfer,,,,Personal,ONLINE TRANSFER TO TECH COMPANY X BOARD MEETING EXPENSES,-1900.0,573177.0
85,Robert King,86,80,29,Debit Card,,,,Shopping,POS PURCHASE #1234 TIFFANY & CO SF,-1400.0,571777.0
86,Robert King,87,81,29,ACH,,,,Bills & utilities,BILL PAY AUTO DEBIT COMCAST SAN FRANCISCO UTILITY BILL,-250.0,571527.0
87,Robert King,88,82,29,Debit Card,,,,Food & drink,POS PURCHASE #2034 FERRY BUILDING MARKETPLACE SF,-95.0,571432.0
88,Robert King,89,83,29,Transfer,,,,Investment,ONLINE TRANSFER TO VANGUARD INDEX FUND INVESTMENT,-120000.0,451432.0
89,Robert King,90,84,29,Debit Card,,,,Travel,POS PURCHASE #4567 JETBLUE MINT CLASS UPGRADE,-3400.0,448032.0
90,Robert King,91,85,29,Debit Card,,,,Health & Wellness,POS PURCHASE #2468 ORANGETHEORY FITNESS MEMBERSHIP SF,-540.0,447492.0
91,Robert King,92,86,29,ACH,,,,Employment,ACH DEPOSIT HEDGE FUND A PAYROLL ROBERT KING,250000.0,697492.0
92,Robert King,93,87,29,Debit Card,,,,Shopping,POS PURCHASE #1234 NORDSTROM SF,-850.0,696642.0
93,Robert King,94,88,29,Debit Card,,,,Food & drink,POS PURCHASE #2034 LA BOULANGERIE SF,-70.0,696572.0
94,Robert King,95,89,29,Debit Card,,,,Entertainment,POS PURCHASE #7890 SF CHAMBER ORCHESTRA TICKETS,-200.0,696372.0
95,Robert King,96,90,29,Transfer,,,,Loan,ONLINE TRANSFER TO MORTGAGE PAYMENT,-25000.0,671372.0
96,Robert King,97,91,29,Debit Card,,,,Gas,POS PURCHASE #9876 ARCO GAS STATION SF,-84.0,671288.0
97,Robert King,98,92,29,ACH,,,,Bills & utilities,BILL PAY AUTO DEBIT PG&E SAN FRANCISCO UTILITY BILL,-320.5,670967.0
98,Robert King,99,93,29,Debit Card,,,,Food & drink,POS PURCHASE #4567 WHOLE FOODS MARKET SF,-60.0,670907.0
99,Robert King,100,2,30,Wire,,,,Donation,OUTGOING WIRE AMERICAN RED CROSS DISASTER RELIEF FUND,-100000.0,50000.0
100,Hanna Smith,196,1,33,ACH,,,,Bills & utilities,BILL PAY AUTO DEBIT PG&E SAN FRANCISCO UTILITY BILL,-120.0,24880.0
101,Hanna Smith,197,2,33,Debit Card,,,,Food & drink,POS PURCHASE #4567 WHOLE FOODS MARKET PA,-35.5,24844.5
102,Hanna Smith,198,3,33,ACH,,,,Employment,ACH CREDIT FARMERS MARKET SALES DEPOSIT,1500.0,26344.5
103,Hanna Smith,199,4,33,Debit Card,,,,Gas,POS PURCHASE #7890 CHEVRON PALO ALTO,-60.0,26284.5
104,Hanna Smith,200,5,33,Debit Card,,,,Shopping,POS PURCHASE #1234 COSTCO WHOLESALE PA,-210.0,26074.5
105,Hanna Smith,201,6,33,Debit Card,,,,Entertainment,POS PURCHASE #2345 AMC THEATRES MOUNTAIN VIEW,-50.0,26024.5
106,Hanna Smith,202,7,33,ACH,,,,Benefits,ACH DEBIT HEALTH INSURANCE PREMIUM,-250.0,25774.5
107,Hanna Smith,203,8,33,Debit Card,,,,Food & drink,POS PURCHASE #2034 STARBUCKS PA,-15.75,25758.8
108,Hanna Smith,204,9,33,Transfer,,,,Personal,TRANSFER TO PERSONAL CHECKING FOR HOUSEHOLD EXPENSES,-100.0,25658.8
109,Hanna Smith,205,10,33,ACH,,,,Employment,ACH CREDIT FARMERS MARKET SALES DEPOSIT,1800.0,27458.8
110,Hanna Smith,206,11,33,Check,,,,Professional Services,CHECK #1023 PAYMENT TO FLORA BAKERY SUPPLIES,-300.0,27158.8
111,Hanna Smith,207,12,33,Debit Card,,,,Grocieries,POS PURCHASE #5678 TRADER JOE'S PA,-120.0,27038.8
112,Hanna Smith,208,13,33,Debit Card,,,,Health & Wellness,POS PURCHASE #6789 CVS PHARMACY PA,-80.0,26958.8
113,Hanna Smith,209,14,33,Wire,,,,Loan,OUTGOING WIRE LOAN REPAYMENT TO WELLS FARGO BANK,-1000.0,25958.8
114,Hanna Smith,210,15,33,ACH,,,,Bills & utilities,BILL PAY AUTO DEBIT AT&T MOBILE BILL,-80.0,25878.8
115,Hanna Smith,211,16,33,Debit Card,,,,Food & drink,POS PURCHASE #7891 PEET'S COFFEE PA,-25.0,25853.8
116,Hanna Smith,212,17,33,ACH,,,,Employment,ACH CREDIT FARMERS MARKET SALES DEPOSIT,1600.0,27453.8
117,Hanna Smith,213,18,33,Debit Card,,,,Shopping,POS PURCHASE #8901 TARGET SAN FRANCISCO,-45.0,27408.8
118,Hanna Smith,214,19,33,Debit Card,,,,Entertainment,POS PURCHASE #9012 NETFLIX SUBSCRIPTION,-75.0,27333.8
119,Hanna Smith,215,20,33,Transfer,,,,Personal,TRANSFER TO PERSONAL CHECKING FOR WEEKEND OUTING,-150.0,27183.8
120,Hanna Smith,216,21,33,ACH,,,,Bills & utilities,BILL PAY AUTO DEBIT CITY OF PALO ALTO WATER BILL,-250.0,26933.8
121,Hanna Smith,217,22,33,Debit Card,,,,Food & drink,POS PURCHASE #0123 PANERA BREAD PA,-18.0,26915.8
122,Hanna Smith,218,23,33,ACH,,,,Employment,ACH CREDIT FARMERS MARKET SALES DEPOSIT,1700.0,28615.8
123,Hanna Smith,219,24,33,Debit Card,,,,Gas,POS PURCHASE #1235 SHELL OIL PALO ALTO,-65.0,28550.8
124,Hanna Smith,220,25,33,Debit Card,,,,Shopping,POS PURCHASE #2346 IKEA EAST PALO ALTO,-130.0,28420.8
125,Hanna Smith,221,26,33,Debit Card,,,,Grocieries,POS PURCHASE #3457 SAFEWAY PALO ALTO,-95.0,28325.8
126,Hanna Smith,222,27,33,Debit Card,,,,Health & Wellness,POS PURCHASE #4568 WALGREENS PA,-60.0,28265.8
127,Hanna Smith,223,28,33,ACH,,,,Benefits,ACH DEBIT HEALTH INSURANCE PREMIUM,-250.0,28015.8
128,Hanna Smith,224,29,33,Debit Card,,,,Food & drink,POS PURCHASE #5679 JAMBA JUICE PA,-22.5,27993.2
129,Hanna Smith,225,30,33,ACH,,,,Employment,ACH CREDIT FARMERS MARKET SALES DEPOSIT,1550.0,29543.2
130,Hanna Smith,226,31,33,Debit Card,,,,Shopping,POS PURCHASE #6780 BED BATH & BEYOND PA,-200.0,29343.2
131,Hanna Smith,227,32,33,ACH,,,,Bills & utilities,BILL PAY AUTO DEBIT PG&E SAN FRANCISCO UTILITY BILL,-120.0,29223.2
132,Hanna Smith,228,33,33,Transfer,,,,Investment,TRANSFER TO SAVINGS FOR FUTURE BUSINESS EXPANSION,-500.0,28723.2
133,Hanna Smith,229,34,33,Debit Card,,,,Food & drink,POS PURCHASE #7892 WHOLE FOODS MARKET PA,-40.0,28683.2
134,Hanna Smith,230,35,33,ACH,,,,Employment,ACH CREDIT FARMERS MARKET SALES DEPOSIT,1650.0,30333.2
135,Hanna Smith,231,36,33,Debit Card,,,,Gas,POS PURCHASE #8903 CHEVRON PALO ALTO,-70.0,30263.2
136,Hanna Smith,232,37,33,Debit Card,,,,Shopping,POS PURCHASE #9014 COSTCO WHOLESALE PA,-220.0,30043.2
137,Hanna Smith,233,38,33,Debit Card,,,,Entertainment,POS PURCHASE #0125 AMC THEATRES MOUNTAIN VIEW,-55.0,29988.2
138,Hanna Smith,234,39,33,ACH,,,,Benefits,ACH DEBIT HEALTH INSURANCE PREMIUM,-250.0,29738.2
139,Hanna Smith,235,40,33,Debit Card,,,,Food & drink,POS PURCHASE #1236 STARBUCKS PA,-17.0,29721.2
140,Hanna Smith,236,41,33,Transfer,,,,Personal,TRANSFER TO PERSONAL CHECKING FOR HOUSEHOLD EXPENSES,-100.0,29621.2
141,Hanna Smith,237,42,33,ACH,,,,Employment,ACH CREDIT FARMERS MARKET SALES DEPOSIT,1750.0,31371.2
142,Hanna Smith,238,43,33,Check,,,,Professional Services,CHECK #1024 PAYMENT TO SUGAR BOWL BAKERY SUPPLY,-320.0,31051.2
143,Hanna Smith,239,44,33,Debit Card,,,,Grocieries,POS PURCHASE #2347 TRADER JOE'S PA,-125.0,30926.2
144,Hanna Smith,240,45,33,Debit Card,,,,Health & Wellness,POS PURCHASE #3458 CVS PHARMACY PA,-85.0,30841.2
145,Hanna Smith,241,46,33,Wire,,,,Loan,OUTGOING WIRE LOAN REPAYMENT TO WELLS FARGO BANK,-1000.0,29841.2
146,Hanna Smith,242,47,33,ACH,,,,Bills & utilities,BILL PAY AUTO DEBIT AT&T MOBILE BILL,-85.0,29756.2
147,Hanna Smith,243,48,33,Debit Card,,,,Food & drink,POS PURCHASE #4569 PEET'S COFFEE PA,-30.0,29726.2
148,Hanna Smith,244,49,33,ACH,,,,Employment,ACH CREDIT FARMERS MARKET SALES DEPOSIT,1600.0,31326.2
149,Hanna Smith,245,50,33,Debit Card,,,,Shopping,POS PURCHASE #5670 TARGET SAN FRANCISCO,-50.0,31276.2
150,Hanna Smith,246,51,33,Debit Card,,,,Entertainment,POS PURCHASE #6781 NETFLIX SUBSCRIPTION,-80.0,31196.2
151,Hanna Smith,247,52,33,Transfer,,,,Personal,TRANSFER TO PERSONAL CHECKING FOR WEEKEND OUTING,-150.0,31046.2
152,Hanna Smith,248,53,33,ACH,,,,Bills & utilities,BILL PAY AUTO DEBIT CITY OF PALO ALTO WATER BILL,-260.0,30786.2
153,Hanna Smith,249,54,33,Debit Card,,,,Food & drink,POS PURCHASE #7893 PANERA BREAD PA,-20.0,30766.2
154,Hanna Smith,250,55,33,ACH,,,,Employment,ACH CREDIT FARMERS MARKET SALES DEPOSIT,1800.0,32566.2
155,Hanna Smith,251,56,33,Debit Card,,,,Gas,POS PURCHASE #8904 SHELL OIL PALO ALTO,-68.0,32498.2
156,Hanna Smith,252,57,33,Debit Card,,,,Shopping,POS PURCHASE #9015 IKEA EAST PALO ALTO,-140.0,32358.2
157,Hanna Smith,253,58,33,Debit Card,,,,Grocieries,POS PURCHASE #0126 SAFEWAY PALO ALTO,-100.0,32258.2
158,Hanna Smith,254,59,33,Debit Card,,,,Health & Wellness,POS PURCHASE #1237 WALGREENS PA,-65.0,32193.2
159,Hanna Smith,255,60,33,ACH,,,,Benefits,ACH DEBIT HEALTH INSURANCE PREMIUM,-250.0,31943.2
160,Hanna Smith,256,61,33,Debit Card,,,,Food & drink,POS PURCHASE #2348 JAMBA JUICE PA,-24.0,31919.2
161,Hanna Smith,257,62,33,ACH,,,,Bills & utilities,BILL PAY AUTO DEBIT PG&E SAN FRANCISCO UTILITY BILL,-120.0,31799.2
162,Hanna Smith,258,63,33,Transfer,,,,Investment,TRANSFER TO SAVINGS FOR FUTURE BUSINESS EXPANSION,-500.0,31299.2
163,Hanna Smith,259,64,33,Debit Card,,,,Food & drink,POS PURCHASE #3459 WHOLE FOODS MARKET PA,-42.0,31257.2
164,Hanna Smith,260,65,33,ACH,,,,Employment,ACH CREDIT FARMERS MARKET SALES DEPOSIT,1700.0,32957.2
165,Hanna Smith,261,66,33,Debit Card,,,,Gas,POS PURCHASE #4560 CHEVRON PALO ALTO,-72.0,32885.2
166,Hanna Smith,262,67,33,Debit Card,,,,Shopping,POS PURCHASE #5671 COSTCO WHOLESALE PA,-225.0,32660.2
167,Hanna Smith,263,68,33,Debit Card,,,,Entertainment,POS PURCHASE #6782 AMC THEATRES MOUNTAIN VIEW,-60.0,32600.2
168,Hanna Smith,264,69,33,ACH,,,,Benefits,ACH DEBIT HEALTH INSURANCE PREMIUM,-250.0,32350.2
169,Hanna Smith,265,70,33,Debit Card,,,,Food & drink,POS PURCHASE #7894 STARBUCKS PA,-19.0,32331.2
170,Hanna Smith,266,71,33,Transfer,,,,Personal,TRANSFER TO PERSONAL CHECKING FOR HOUSEHOLD EXPENSES,-100.0,32231.2
171,Hanna Smith,267,72,33,ACH,,,,Employment,ACH CREDIT FARMERS MARKET SALES DEPOSIT,1850.0,34081.2
172,Hanna Smith,268,73,33,Check,,,,Professional Services,CHECK #1025 PAYMENT TO BAKERS CHOICE SUPPLY CO,-340.0,33741.2
173,Hanna Smith,269,74,33,Debit Card,,,,Grocieries,POS PURCHASE #8905 TRADER JOE'S PA,-130.0,33611.2
174,Hanna Smith,270,75,33,Debit Card,,,,Health & Wellness,POS PURCHASE #9016 CVS PHARMACY PA,-90.0,33521.2
175,Hanna Smith,271,76,33,Wire,,,,Loan,OUTGOING WIRE LOAN REPAYMENT TO WELLS FARGO BANK,-1000.0,32521.2
176,Hanna Smith,272,77,33,ACH,,,,Bills & utilities,BILL PAY AUTO DEBIT AT&T MOBILE BILL,-90.0,32431.2
177,Hanna Smith,273,78,33,Debit Card,,,,Food & drink,POS PURCHASE #0127 PEET'S COFFEE PA,-32.0,32399.2
178,Hanna Smith,274,79,33,ACH,,,,Employment,ACH CREDIT FARMERS MARKET SALES DEPOSIT,1750.0,34149.2
179,Hanna Smith,275,80,33,Debit Card,,,,Shopping,POS PURCHASE #1238 TARGET SAN FRANCISCO,-55.0,34094.2
180,Hanna Smith,276,81,33,Debit Card,,,,Entertainment,POS PURCHASE #2349 NETFLIX SUBSCRIPTION,-85.0,34009.2
181,Hanna Smith,277,82,33,Transfer,,,,Personal,TRANSFER TO PERSONAL CHECKING FOR WEEKEND OUTING,-150.0,33859.2
182,Hanna Smith,278,83,33,ACH,,,,Bills & utilities,BILL PAY AUTO DEBIT CITY OF PALO ALTO WATER BILL,-270.0,33589.2
183,Hanna Smith,279,84,33,Debit Card,,,,Food & drink,POS PURCHASE #3450 PANERA BREAD PA,-23.0,33566.2
184,Hanna Smith,280,85,33,ACH,,,,Employment,ACH CREDIT FARMERS MARKET SALES DEPOSIT,1900.0,35466.2
185,Hanna Smith,281,86,33,Debit Card,,,,Gas,POS PURCHASE #4561 SHELL OIL PALO ALTO,-71.0,35395.2
186,Hanna Smith,282,87,33,Debit Card,,,,Shopping,POS PURCHASE #5672 IKEA EAST PALO ALTO,-145.0,35250.2
187,Hanna Smith,283,88,33,Debit Card,,,,Grocieries,POS PURCHASE #6783 SAFEWAY PALO ALTO,-105.0,35145.2
188,Hanna Smith,284,89,33,Debit Card,,,,Health & Wellness,POS PURCHASE #7895 WALGREENS PA,-70.0,35075.2
189,Hanna Smith,285,90,33,ACH,,,,Benefits,ACH DEBIT HEALTH INSURANCE PREMIUM,-250.0,34825.2
190,Hanna Smith,286,91,33,Debit Card,,,,Food & drink,POS PURCHASE #8906 JAMBA JUICE PA,-26.0,34799.2
191,Hanna Smith,287,92,33,ACH,,,,Bills & utilities,BILL PAY AUTO DEBIT PG&E SAN FRANCISCO UTILITY BILL,-120.0,34679.2
192,Hanna Smith,288,93,33,Transfer,,,,Investment,TRANSFER TO SAVINGS FOR FUTURE BUSINESS EXPANSION,-500.0,34179.2
193,Hanna Smith,289,1,34,Transfer,,,,Investment,TRANSFER TO SAVINGS FOR FUTURE BUSINESS EXPANSION,-500.0,24500.0
194,Jerry Smith,444,1,38,ACH,,,,Benefits,ACH CREDIT MOTORSPORTS INC RACE WINNINGS,5000.0,215000.0
195,Jerry Smith,445,1,38,Transfer,,,,Investment,TRANSFER TO VANGUARD INVESTMENT ACCOUNT,-10000.0,205000.0
196,Jerry Smith,446,2,38,Debit Card,,,,Food & drink,POS PURCHASE #4567 MARIO'S PIZZERIA NY,-120.45,204880.0
197,Jerry Smith,447,2,38,Debit Card,,,,Entertainment,POS PURCHASE #7890 RACEWAY TICKETS NY,-200.0,204680.0
198,Jerry Smith,448,3,38,Bill Pay,,,,Bills & utilities,BILL PAY AUTO DEBIT VERIZON WIRELESS PHONE BILL,-150.0,204530.0
199,Jerry Smith,449,3,38,Zelle,,,,Gift & Donations,ZELLE DONATION RECEIVED FROM FAN CLUB,1000.0,205530.0
200,Jerry Smith,450,4,38,Wire,,,,Donations,OUTGOING WIRE TO CHILDREN'S CHARITY FUND,-50000.0,155530.0
201,Jerry Smith,451,5,38,Debit Card,,,,Gas,POS PURCHASE #9876 SHELL GAS STATION NY,-75.3,155454.0
202,Jerry Smith,452,5,38,Debit Card,,,,Shopping,POS PURCHASE #1234 RACING GEAR SHOP NY,-450.0,155004.0
203,Jerry Smith,453,6,38,ACH,,,,Loan,ACH DEBIT CAR LOAN PAYMENT #4567,-2000.0,153004.0
204,Jerry Smith,454,7,38,Transfer,,,,Personal,TRANSFER TO SAVINGS ACCOUNT,-300.0,152704.0
205,Jerry Smith,455,8,38,Debit Card,,,,Food & drink,POS PURCHASE #2034 STARBUCKS NY,-15.75,152688.0
206,Jerry Smith,456,8,38,Debit Card,,,,Travel,POS PURCHASE #5678 DELTA AIRLINES TICKET,-300.0,152388.0
207,Jerry Smith,457,9,38,ACH,,,,Employment,ACH CREDIT MOTORSPORTS INC MONTHLY SALARY,15000.0,167388.0
208,Jerry Smith,458,10,38,Debit Card,,,,Health & Wellness,POS PURCHASE #6789 GNC STORE NY,-60.0,167328.0
209,Jerry Smith,459,11,38,ACH,,,,Bills & utilities,ACH DEBIT CON EDISON ELECTRIC BILL NY,-250.0,167078.0
210,Jerry Smith,460,12,38,Debit Card,,,,Groceries,POS PURCHASE #7891 WHOLE FOODS MARKET NY,-210.5,166868.0
211,Jerry Smith,461,13,38,Transfer,,,,Donations,TRANSFER TO LOCAL FOOD BANK DONATION,-1000.0,165868.0
212,Jerry Smith,462,14,38,Debit Card,,,,Entertainment,POS PURCHASE #8901 BROADWAY SHOW TICKETS NY,-350.0,165518.0
213,Jerry Smith,463,15,38,Debit Card,,,,Travel,POS PURCHASE #9012 UBER RIDE TO AIRPORT,-120.0,165398.0
214,Jerry Smith,464,16,38,ACH,,,,Benefits,ACH CREDIT MOTORSPORTS INC ENDORSEMENT DEAL,7500.0,172898.0
215,Jerry Smith,465,17,38,Debit Card,,,,Food & drink,POS PURCHASE #0123 MICHELIN STAR RESTAURANT NY,-85.0,172813.0
216,Jerry Smith,466,18,38,Debit Card,,,,Shopping,POS PURCHASE #2345 HIGH-END ELECTRONICS STORE NY,-650.0,172163.0
217,Jerry Smith,467,19,38,Transfer,,,,Investment,TRANSFER TO CHARLES SCHWAB INVESTMENT ACCOUNT,-5000.0,167163.0
218,Jerry Smith,468,20,38,Debit Card,,,,Gas,POS PURCHASE #3456 BP GAS STATION NY,-80.0,167083.0
219,Jerry Smith,469,21,38,Debit Card,,,,Shopping,POS PURCHASE #4567 RACE SUIT CUSTOMIZATION NY,-400.0,166683.0
220,Jerry Smith,470,22,38,ACH,,,,Donations,ACH DEBIT TO CANCER RESEARCH FOUNDATION DONATION,-15000.0,151683.0
221,Jerry Smith,471,23,38,Debit Card,,,,Food & drink,POS PURCHASE #5678 SUBWAY SANDWICHES NY,-30.0,151653.0
222,Jerry Smith,472,24,38,Debit Card,,,,Entertainment,POS PURCHASE #6789 CONCERT TICKETS NY,-250.0,151403.0
223,Jerry Smith,473,25,38,ACH,,,,Bills & utilities,ACH DEBIT SPECTRUM INTERNET BILL NY,-180.0,151223.0
224,Jerry Smith,474,26,38,Debit Card,,,,Groceries,POS PURCHASE #7892 TRADER JOE'S MARKET NY,-195.75,151027.0
225,Jerry Smith,475,27,38,Transfer,,,,Personal,TRANSFER TO SAVINGS ACCOUNT,-500.0,150527.0
226,Jerry Smith,476,28,38,Debit Card,,,,Travel,POS PURCHASE #8902 HILTON HOTEL BOOKING NY,-250.0,150277.0
227,Jerry Smith,477,29,38,ACH,,,,Employment,ACH CREDIT MOTORSPORTS INC MONTHLY SALARY,15000.0,165277.0
228,Jerry Smith,478,30,38,Debit Card,,,,Health & Wellness,POS PURCHASE #9013 24 HOUR FITNESS MEMBERSHIP NY,-100.0,165177.0
229,Jerry Smith,479,31,38,ACH,,,,Bills & utilities,ACH DEBIT NATIONAL GRID GAS BILL NY,-300.0,164877.0
230,Jerry Smith,480,32,38,Transfer,,,,Investment,TRANSFER TO VANGUARD INVESTMENT ACCOUNT,-10000.0,154877.0
231,Jerry Smith,481,33,38,Debit Card,,,,Food & drink,POS PURCHASE #0124 FANCY STEAKHOUSE NY,-130.5,154747.0
232,Jerry Smith,482,34,38,Bill Pay,,,,Bills & utilities,BILL PAY AUTO DEBIT T-MOBILE PHONE BILL,-160.0,154587.0
233,Jerry Smith,483,35,38,Zelle,,,,Gift & Donations,ZELLE DONATION RECEIVED FROM FAN CLUB,1500.0,156087.0
234,Jerry Smith,484,36,38,Wire,,,,Donations,OUTGOING WIRE TO GLOBAL RELIEF FUND,-55000.0,101087.0
235,Jerry Smith,485,37,38,Debit Card,,,,Gas,POS PURCHASE #2346 EXXON GAS STATION NY,-78.2,101009.0
236,Jerry Smith,486,38,38,Debit Card,,,,Shopping,POS PURCHASE #3457 MOTORSPORTS ACCESSORIES NY,-480.0,100529.0
237,Jerry Smith,487,39,38,ACH,,,,Loan,ACH DEBIT CAR LOAN PAYMENT #5678,-2050.0,98478.5
238,Jerry Smith,488,40,38,Transfer,,,,Personal,TRANSFER TO SAVINGS ACCOUNT,-320.0,98158.5
239,Jerry Smith,489,41,38,Debit Card,,,,Food & drink,POS PURCHASE #4568 STARBUCKS NY,-18.0,98140.5
240,Jerry Smith,490,42,38,Debit Card,,,,Travel,POS PURCHASE #5679 AMERICAN AIRLINES TICKET,-320.0,97820.5
241,Jerry Smith,491,43,38,ACH,,,,Employment,ACH CREDIT MOTORSPORTS INC MONTHLY SALARY,15500.0,113321.0
242,Jerry Smith,492,44,38,Debit Card,,,,Health & Wellness,POS PURCHASE #6780 VITAMIN SHOPPE NY,-65.0,113256.0
243,Jerry Smith,493,45,38,ACH,,,,Bills & utilities,ACH DEBIT PSEG ELECTRIC BILL NY,-260.0,112996.0
244,Jerry Smith,494,46,38,Debit Card,,,,Groceries,POS PURCHASE #7893 COSTCO WHOLESALE NY,-220.6,112775.0
245,Jerry Smith,495,47,38,Transfer,,,,Donations,TRANSFER TO ANIMAL WELFARE ORGANIZATION DONATION,-1050.0,111725.0
246,Jerry Smith,496,48,38,Debit Card,,,,Entertainment,POS PURCHASE #8903 RACE TRACK VIP PASS NY,-360.0,111365.0
247,Jerry Smith,497,49,38,Debit Card,,,,Travel,POS PURCHASE #9014 LYFT RIDE TO EVENT,-125.0,111240.0
248,Jerry Smith,498,50,38,ACH,,,,Benefits,ACH CREDIT MOTORSPORTS INC BONUS PAYMENT,7700.0,118940.0
249,Jerry Smith,499,51,38,Debit Card,,,,Food & drink,POS PURCHASE #0125 HIGH-END SUSHI RESTAURANT NY,-90.0,118850.0
250,Jerry Smith,500,52,38,Debit Card,,,,Shopping,POS PURCHASE #1236 LUXURY WATCH STORE NY,-670.0,118180.0
251,Jerry Smith,501,53,38,Transfer,,,,Investment,TRANSFER TO FIDELITY INVESTMENT ACCOUNT,-5200.0,112980.0
252,Jerry Smith,502,54,38,Debit Card,,,,Gas,POS PURCHASE #2347 MOBIL GAS STATION NY,-82.0,112898.0
253,Jerry Smith,503,55,38,Debit Card,,,,Shopping,POS PURCHASE #3458 CUSTOM RACING HELMET NY,-420.0,112478.0
254,Jerry Smith,504,56,38,ACH,,,,Donations,ACH DEBIT TO DISASTER RELIEF FUND DONATION,-15500.0,96978.0
255,Jerry Smith,505,57,38,Debit Card,,,,Food & drink,POS PURCHASE #4569 DOMINO'S PIZZA NY,-35.0,96943.0
256,Jerry Smith,506,58,38,Debit Card,,,,Entertainment,POS PURCHASE #5670 BOWLING ALLEY PARTY NY,-260.0,96683.0
257,Jerry Smith,507,59,38,ACH,,,,Bills & utilities,ACH DEBIT TIME WARNER CABLE BILL NY,-190.0,96493.0
258,Jerry Smith,508,60,38,Debit Card,,,,Groceries,POS PURCHASE #6781 FAIRWAY MARKET NY,-200.85,96292.1
259,Jerry Smith,509,61,38,Transfer,,,,Personal,TRANSFER TO SAVINGS ACCOUNT,-550.0,95742.1
260,Jerry Smith,510,62,38,ACH,,,,Bills & utilities,ACH DEBIT NATIONAL GRID GAS BILL NY,-320.0,95422.1
261,Jerry Smith,511,63,38,Debit Card,,,,Food & drink,POS PURCHASE #7894 ITALIAN RESTAURANT NY,-140.55,95281.5
262,Jerry Smith,512,64,38,Bill Pay,,,,Bills & utilities,BILL PAY AUTO DEBIT AT&T PHONE BILL,-170.0,95111.5
263,Jerry Smith,513,65,38,Zelle,,,,Gift & Donations,ZELLE DONATION RECEIVED FROM FAN CLUB,2000.0,97111.5
264,Jerry Smith,514,66,38,Wire,,,,Donations,OUTGOING WIRE TO EDUCATION FOR ALL FUND,-60000.0,37111.6
265,Jerry Smith,515,67,38,Debit Card,,,,Gas,POS PURCHASE #8904 SUNOCO GAS STATION NY,-81.1,37030.4
266,Jerry Smith,516,68,38,Debit Card,,,,Shopping,POS PURCHASE #9015 PERFORMANCE RACING PARTS NY,-510.0,36520.4
267,Jerry Smith,517,69,38,ACH,,,,Loan,ACH DEBIT CAR LOAN PAYMENT #6789,-2100.0,34420.4
268,Jerry Smith,518,70,38,Transfer,,,,Personal,TRANSFER TO SAVINGS ACCOUNT,-340.0,34080.4
269,Jerry Smith,519,71,38,Debit Card,,,,Food & drink,POS PURCHASE #0126 STARBUCKS NY,-20.25,34060.2
270,Jerry Smith,520,72,38,Debit Card,,,,Travel,POS PURCHASE #1237 JETBLUE AIRWAYS TICKET,-340.0,33720.2
271,Jerry Smith,521,73,38,ACH,,,,Employment,ACH CREDIT MOTORSPORTS INC MONTHLY SALARY,16000.0,49720.2
272,Jerry Smith,522,74,38,Debit Card,,,,Health & Wellness,POS PURCHASE #2348 GNC STORE NY,-70.0,49650.2
273,Jerry Smith,523,75,38,ACH,,,,Bills & utilities,ACH DEBIT CON EDISON ELECTRIC BILL NY,-270.0,49380.2
274,Jerry Smith,524,76,38,Debit Card,,,,Groceries,POS PURCHASE #3459 BJ'S WHOLESALE CLUB NY,-230.7,49149.5
275,Jerry Smith,525,77,38,Transfer,,,,Donations,TRANSFER TO VETERANS SUPPORT ORGANIZATION DONATION,-1100.0,48049.5
276,Jerry Smith,526,78,38,Debit Card,,,,Entertainment,POS PURCHASE #4560 NASCAR EVENT TICKETS NY,-370.0,47679.5
277,Jerry Smith,527,79,38,Debit Card,,,,Travel,POS PURCHASE #5671 TAXI RIDE TO HOTEL,-130.0,47549.5
278,Jerry Smith,528,80,38,ACH,,,,Benefits,ACH CREDIT MOTORSPORTS INC SPONSORSHIP BONUS,7900.0,55449.5
279,Jerry Smith,529,81,38,Debit Card,,,,Food & drink,POS PURCHASE #6782 FINE DINING RESTAURANT NY,-95.0,55354.5
280,Jerry Smith,530,82,38,Debit Card,,,,Shopping,POS PURCHASE #7895 DESIGNER CLOTHING STORE NY,-690.0,54664.5
281,Jerry Smith,531,83,38,Transfer,,,,Investment,TRANSFER TO ROBINHOOD INVESTMENT ACCOUNT,-5400.0,49264.5
282,Jerry Smith,532,84,38,Debit Card,,,,Gas,POS PURCHASE #8905 CHEVRON GAS STATION NY,-84.0,49180.5
283,Jerry Smith,533,85,38,Debit Card,,,,Shopping,POS PURCHASE #9016 CUSTOM LEATHER RACING GLOVES NY,-440.0,48740.5
284,Jerry Smith,534,86,38,ACH,,,,Donations,ACH DEBIT TO HABITAT FOR HUMANITY DONATION,-16000.0,32740.5
285,Jerry Smith,535,87,38,Debit Card,,,,Food & drink,POS PURCHASE #0127 CHIPOTLE MEXICAN GRILL NY,-40.0,32700.5
286,Jerry Smith,536,88,38,Debit Card,,,,Entertainment,POS PURCHASE #1238 AMUSEMENT PARK TICKETS NY,-270.0,32430.5
287,Jerry Smith,537,89,38,ACH,,,,Bills & utilities,ACH DEBIT SPECTRUM INTERNET BILL NY,-200.0,32230.5
288,Jerry Smith,538,90,38,Debit Card,,,,Groceries,POS PURCHASE #2349 SAFEWAY SUPERMARKET NY,-205.95,32024.6
289,Jerry Smith,539,91,38,Transfer,,,,Personal,TRANSFER TO SAVINGS ACCOUNT,-580.0,31444.6
290,Jerry Smith,540,92,38,ACH,,,,Bills & utilities,ACH DEBIT NATIONAL GRID GAS BILL NY,-340.0,31104.6
291,Jerry Smith,541,93,38,Transfer,,,,Investment,TRANSFER TO VANGUARD INVESTMENT ACCOUNT,-10000.0,21104.6
292,Mariann Avocado,542,1,39,ACH,,,,Benefits,ACH CREDIT ENERTECH INC MONTHLY SALARY,5000.0,85000.0
293,Mariann Avocado,543,1,39,Debit Card,,,,Food & drink,POS PURCHASE #4567 WHOLE FOODS MKT,-15.75,84984.2
294,Mariann Avocado,544,2,39,Wire,,,,Investment,OUTGOING WIRE TO BLOOMBERG INVESTMENT FUND,-10000.0,74984.2
295,Mariann Avocado,545,2,39,Bill Pay,,,,Bills & utilities,BILL PAY AUTO DEBIT PG&E SAN FRANCISCO UTILITY BILL,-120.0,74864.2
296,Mariann Avocado,546,3,39,Debit Card,,,,Travel,POS PURCHASE #7890 DELTA AIR TICKET,-350.0,74514.2
297,Mariann Avocado,547,3,39,ACH,,,,Loan,ACH DEBIT CAR LOAN PAYMENT TO CHASE AUTO FIN,-1500.0,73014.2
298,Mariann Avocado,548,4,39,Transfer,,,,Home,TRANSFER TO MORTGAGE FOR WELLS FARGO HOME LOAN,-2000.0,71014.2
299,Mariann Avocado,549,5,39,Zelle,,,,Personal,ZELLE PAYMENT SENT TO JAMES PEACH,-250.0,70764.2
300,Mariann Avocado,550,5,39,Debit Card,,,,Gas,POS PURCHASE #9876 CHEVRON STATION,-60.0,70704.2
301,Mariann Avocado,551,6,39,Debit Card,,,,Grocieries,POS PURCHASE #4567 SAFEWAY STORE,-95.5,70608.8
302,Mariann Avocado,552,7,39,ACH,,,,Tax,ACH DEBIT IRS PAYMENT,-500.0,70108.8
303,Mariann Avocado,553,8,39,Debit Card,,,,Entertainment,POS PURCHASE #1234 AMC THEATERS,-80.0,70028.8
304,Mariann Avocado,554,9,39,Transfer,,,,Investment,INCOMING TRANSFER FROM ENERTECH INVESTMENT ACCOUNT,15000.0,85028.8
305,Mariann Avocado,555,10,39,Debit Card,,,,Health & Wellness,POS PURCHASE #6789 CVS PHARMACY,-45.0,84983.8
306,Mariann Avocado,556,11,39,ACH,,,,Employment,ACH DEBIT PAYROLL ENERTECH STAFF,-2500.0,82483.8
307,Mariann Avocado,557,12,39,Debit Card,,,,Shopping,POS PURCHASE #4321 NORDSTROM INC,-180.0,82303.8
308,Mariann Avocado,558,13,39,Transfer,,,,Investment,TRANSFER TO VANGUARD RETIREMENT FUND,-5000.0,77303.8
309,Mariann Avocado,559,14,39,Debit Card,,,,Food & drink,POS PURCHASE #2034 STARBUCKS SF,-30.0,77273.8
310,Mariann Avocado,560,15,39,ACH,,,,Bills & utilities,ACH DEBIT COMCAST SAN FRANCISCO INTERNET BILL,-250.0,77023.8
311,Mariann Avocado,561,16,39,Debit Card,,,,Travel,POS PURCHASE #7890 UBER RIDE,-120.0,76903.8
312,Mariann Avocado,562,17,39,Wire,,,,Professional Services,OUTGOING WIRE TO MCKINSEY CONSULTING SERVICES,-3000.0,73903.8
313,Mariann Avocado,563,18,39,Debit Card,,,,Entertainment,POS PURCHASE #1234 SPOTIFY PREMIUM SUBSCRIPTION,-50.0,73853.8
314,Mariann Avocado,564,19,39,Transfer,,,,Investment,TRANSFER TO CHARLES SCHWAB INVESTMENT ACCOUNT,-10000.0,63853.8
315,Mariann Avocado,565,20,39,Debit Card,,,,Gas,POS PURCHASE #9876 SHELL OIL,-75.0,63778.8
316,Mariann Avocado,566,21,39,ACH,,,,Education,ACH DEBIT TUITION PAYMENT TO STANFORD UNIVERSITY,-2000.0,61778.8
317,Mariann Avocado,567,22,39,Debit Card,,,,Shopping,POS PURCHASE #4321 APPLE STORE,-250.0,61528.8
318,Mariann Avocado,568,23,39,Transfer,,,,Loan,TRANSFER TO STUDENT LOAN PAYMENT,-1500.0,60028.8
319,Mariann Avocado,569,24,39,Debit Card,,,,Food & drink,POS PURCHASE #2034 STARBUCKS SF,-20.0,60008.8
320,Mariann Avocado,570,25,39,ACH,,,,Benefits,ACH CREDIT ENERTECH INC MONTHLY SALARY,5000.0,65008.8
321,Mariann Avocado,571,26,39,Debit Card,,,,Grocieries,POS PURCHASE #4567 TRADER JOE'S,-110.0,64898.8
322,Mariann Avocado,572,27,39,Debit Card,,,,Health & Wellness,POS PURCHASE #6789 WALGREENS,-60.0,64838.8
323,Mariann Avocado,573,28,39,Transfer,,,,Investment,TRANSFER TO FIDELITY INVESTMENT FUND,-7500.0,57338.8
324,Mariann Avocado,574,29,39,Debit Card,,,,Entertainment,POS PURCHASE #1234 NETFLIX SUBSCRIPTION,-15.0,57323.8
325,Mariann Avocado,575,30,39,ACH,,,,Bills & utilities,ACH DEBIT VERIZON WIRELESS BILL,-130.0,57193.8
326,Mariann Avocado,576,31,39,Debit Card,,,,Travel,POS PURCHASE #7890 LYFT RIDE,-85.0,57108.8
327,Mariann Avocado,577,32,39,Wire,,,,Investment,OUTGOING WIRE TO GOLDMAN SACHS INVESTMENT FUND,-10000.0,47108.8
328,Mariann Avocado,578,33,39,Debit Card,,,,Food & drink,POS PURCHASE #2034 STARBUCKS SF,-40.0,47068.8
329,Mariann Avocado,579,34,39,ACH,,,,Loan,ACH DEBIT CAR LOAN PAYMENT TO CHASE AUTO FIN,-1500.0,45568.8
330,Mariann Avocado,580,35,39,Transfer,,,,Home,TRANSFER TO MORTGAGE FOR WELLS FARGO HOME LOAN,-2000.0,43568.8
331,Mariann Avocado,581,36,39,Zelle,,,,Personal,ZELLE PAYMENT SENT TO ANNA GUACAMOLE,-300.0,43268.8
332,Mariann Avocado,582,37,39,Debit Card,,,,Gas,POS PURCHASE #9876 TEXACO STATION,-65.0,43203.8
333,Mariann Avocado,583,38,39,Debit Card,,,,Grocieries,POS PURCHASE #4567 WHOLE FOODS MKT,-100.0,43103.8
334,Mariann Avocado,584,39,39,ACH,,,,Tax,ACH DEBIT IRS QUARTERLY PAYMENT,-550.0,42553.8
335,Mariann Avocado,585,40,39,Debit Card,,,,Entertainment,POS PURCHASE #1234 TICKETMASTER CONCERT,-90.0,42463.8
336,Mariann Avocado,586,41,39,Transfer,,,,Investment,INCOMING TRANSFER FROM ENERTECH OPERATING ACCOUNT,20000.0,62463.8
337,Mariann Avocado,587,42,39,Debit Card,,,,Health & Wellness,POS PURCHASE #6789 RITE AID PHARMACY,-50.0,62413.8
338,Mariann Avocado,588,43,39,ACH,,,,Employment,ACH DEBIT PAYROLL ENERTECH STAFF,-2600.0,59813.8
339,Mariann Avocado,589,44,39,Debit Card,,,,Shopping,POS PURCHASE #4321 ZARA CLOTHING,-190.0,59623.8
340,Mariann Avocado,590,45,39,Transfer,,,,Investment,TRANSFER TO ROBINHOOD INVESTMENT ACCOUNT,-5500.0,54123.8
341,Mariann Avocado,591,46,39,Debit Card,,,,Food & drink,POS PURCHASE #2034 STARBUCKS SF,-35.0,54088.8
342,Mariann Avocado,592,47,39,ACH,,,,Bills & utilities,ACH DEBIT AT&T SAN FRANCISCO INTERNET BILL,-260.0,53828.8
343,Mariann Avocado,593,48,39,Debit Card,,,,Travel,POS PURCHASE #7890 SOUTHWEST AIR TICKET,-130.0,53698.8
344,Mariann Avocado,594,49,39,Wire,,,,Professional Services,OUTGOING WIRE TO DELOITTE CONSULTING LLP,-3200.0,50498.8
345,Mariann Avocado,595,50,39,Debit Card,,,,Entertainment,POS PURCHASE #1234 HBO MAX SUBSCRIPTION,-55.0,50443.8
346,Mariann Avocado,596,51,39,Transfer,,,,Investment,TRANSFER TO MERRILL LYNCH INVESTMENT ACCOUNT,-10500.0,39943.8
347,Mariann Avocado,597,52,39,Debit Card,,,,Gas,POS PURCHASE #9876 BP GAS STATION,-80.0,39863.8
348,Mariann Avocado,598,53,39,ACH,,,,Education,ACH DEBIT TUITION PAYMENT TO HARVARD BUSINESS SCHOOL,-2100.0,37763.8
349,Mariann Avocado,599,54,39,Debit Card,,,,Shopping,POS PURCHASE #4321 BEST BUY ELECTRONICS,-260.0,37503.8
350,Mariann Avocado,600,55,39,Transfer,,,,Loan,TRANSFER TO PERSONAL LOAN PAYMENT,-1550.0,35953.8
351,Mariann Avocado,601,56,39,Debit Card,,,,Food & drink,POS PURCHASE #2034 STARBUCKS SF,-25.0,35928.8
352,Mariann Avocado,602,57,39,ACH,,,,Benefits,ACH CREDIT ENERTECH INC MONTHLY SALARY,5200.0,41128.8
353,Mariann Avocado,603,58,39,Debit Card,,,,Grocieries,POS PURCHASE #4567 KROGER MARKET,-115.0,41013.8
354,Mariann Avocado,604,59,39,Debit Card,,,,Health & Wellness,POS PURCHASE #6789 CVS PHARMACY,-65.0,40948.8
355,Mariann Avocado,605,60,39,Transfer,,,,Investment,TRANSFER TO BLACKROCK INVESTMENT FUND,-7800.0,33148.8
356,Mariann Avocado,606,61,39,Debit Card,,,,Entertainment,POS PURCHASE #1234 DISNEY PLUS SUBSCRIPTION,-18.0,33130.8
357,Mariann Avocado,607,62,39,ACH,,,,Bills & utilities,ACH DEBIT SPRINT WIRELESS BILL,-135.0,32995.8
358,Mariann Avocado,608,63,39,Debit Card,,,,Travel,POS PURCHASE #7890 AMTRAK TICKET,-88.0,32907.8
359,Mariann Avocado,609,64,39,Wire,,,,Investment,OUTGOING WIRE TO JP MORGAN INVESTMENT FUND,-10200.0,22707.8
360,Mariann Avocado,610,65,39,Debit Card,,,,Food & drink,POS PURCHASE #2034 STARBUCKS SF,-45.0,22662.8
361,Mariann Avocado,611,66,39,ACH,,,,Loan,ACH DEBIT CAR LOAN PAYMENT TO CHASE AUTO FIN,-1550.0,21112.8
362,Mariann Avocado,612,67,39,Transfer,,,,Home,TRANSFER TO MORTGAGE FOR WELLS FARGO HOME LOAN,-2050.0,19062.8
363,Mariann Avocado,613,68,39,Zelle,,,,Personal,ZELLE PAYMENT SENT TO OLIVIA AVOCADO,-320.0,18742.8
364,Mariann Avocado,614,69,39,Debit Card,,,,Gas,POS PURCHASE #9876 EXXON STATION,-70.0,18672.8
365,Mariann Avocado,615,70,39,Debit Card,,,,Grocieries,POS PURCHASE #4567 COSTCO WHOLESALE,-105.0,18567.8
366,Mariann Avocado,616,71,39,ACH,,,,Tax,ACH DEBIT STATE TAX PAYMENT,-570.0,17997.8
367,Mariann Avocado,617,72,39,Debit Card,,,,Entertainment,POS PURCHASE #1234 CINEPLEX ODEON TICKETS,-95.0,17902.8
368,Mariann Avocado,618,73,39,Transfer,,,,Investment,INCOMING TRANSFER FROM ENERTECH RESERVE ACCOUNT,20500.0,38402.8
369,Mariann Avocado,619,74,39,Debit Card,,,,Health & Wellness,POS PURCHASE #6789 WALMART PHARMACY,-55.0,38347.8
370,Mariann Avocado,620,75,39,ACH,,,,Employment,ACH DEBIT PAYROLL ENERTECH STAFF,-2700.0,35647.8
371,Mariann Avocado,621,76,39,Debit Card,,,,Shopping,POS PURCHASE #4321 IKEA FURNITURE,-200.0,35447.8
372,Mariann Avocado,622,77,39,Transfer,,,,Investment,TRANSFER TO E*TRADE INVESTMENT ACCOUNT,-5600.0,29847.8
373,Mariann Avocado,623,78,39,Debit Card,,,,Food & drink,POS PURCHASE #2034 STARBUCKS SF,-40.0,29807.8
374,Mariann Avocado,624,79,39,ACH,,,,Bills & utilities,ACH DEBIT T-MOBILE SAN FRANCISCO PHONE BILL,-270.0,29537.8
375,Mariann Avocado,625,80,39,Debit Card,,,,Travel,POS PURCHASE #7890 HERTZ CAR RENTAL,-135.0,29402.8
376,Mariann Avocado,626,81,39,Wire,,,,Professional Services,OUTGOING WIRE TO BAIN & COMPANY CONSULTING,-3400.0,26002.8
377,Mariann Avocado,627,82,39,Debit Card,,,,Entertainment,POS PURCHASE #1234 APPLE MUSIC SUBSCRIPTION,-60.0,25942.8
378,Mariann Avocado,628,83,39,Transfer,,,,Investment,TRANSFER TO RAYMOND JAMES INVESTMENT ACCOUNT,-11000.0,14942.8
379,Mariann Avocado,629,84,39,Debit Card,,,,Gas,POS PURCHASE #9876 MOBIL GAS STATION,-85.0,14857.8
380,Mariann Avocado,630,85,39,ACH,,,,Education,ACH DEBIT TUITION PAYMENT TO MIT SLOAN MANAGEMENT,-2200.0,12657.8
381,Mariann Avocado,631,86,39,Debit Card,,,,Shopping,POS PURCHASE #4321 MICROSOFT STORE,-275.0,12382.8
382,Mariann Avocado,632,87,39,Transfer,,,,Loan,TRANSFER TO MORTGAGE PAYMENT,-1600.0,10782.8
383,Mariann Avocado,633,88,39,Debit Card,,,,Food & drink,POS PURCHASE #2034 STARBUCKS SF,-28.0,10754.8
384,Mariann Avocado,634,89,39,ACH,,,,Benefits,ACH CREDIT ENERTECH INC MONTHLY SALARY,5400.0,16154.8
385,Mariann Avocado,635,90,39,Debit Card,,,,Grocieries,POS PURCHASE #4567 PUBLIX SUPER MARKET,-120.0,16034.8
386,Mariann Avocado,636,91,39,Debit Card,,,,Health & Wellness,POS PURCHASE #6789 DUANE READE,-70.0,15964.8
387,Mariann Avocado,637,92,39,Transfer,,,,Investment,TRANSFER TO T. ROWE PRICE INVESTMENT FUND,-8000.0,7964.75
388,Mariann Avocado,638,93,39,ACH,,,,Bills & utilities,ACH DEBIT SPECTRUM INTERNET BILL,-140.0,7824.75
389,Velvet Throat,639,1,40,ACH,,,,Benefits,ACH CREDIT SAG-AFTRA ROYALTIES FOR ONE PIECE,25000.0,56000.0
390,Velvet Throat,640,2,40,Debit Card,,,,Food & drink,POS PURCHASE #4567 WHOLE FOODS MARKET AZ,-120.45,55879.6
391,Velvet Throat,641,4,40,Zelle,,,,Personal,ZELLE PAYMENT SENT TO JANE DOE FOR PIANO LESSONS,-200.0,55679.6
392,Velvet Throat,642,6,40,PayPal,,,,Entertainment,PAYPAL TRANSACTION TO NETFLIX.COM SUBSCRIPTION,-35.99,55643.6
393,Velvet Throat,643,9,40,Apple Pay,,,,Health & Wellness,APPLE PAY TRANSACTION TO LULULEMON ATHLETICA,-89.95,55553.6
394,Velvet Throat,644,12,40,Bill Pay,,,,Bills & utilities,BILL PAY AUTO DEBIT VERIZON WIRELESS PHONE BILL,-180.0,55373.6
395,Velvet Throat,645,15,40,Google Wallet,,,,Food & drink,GOOGLE WALLET TRANSACTION TO STARBUCKS COFFEE,-15.75,55357.9
396,Velvet Throat,646,18,40,Transfer,,,,Personal,TRANSFER TO SAVINGS ACCOUNT,-500.0,54857.9
397,Velvet Throat,647,21,40,Bill Pay,,,,Bills & utilities,BILL PAY AUTO DEBIT APS ELECTRICITY BILL AZ,-210.0,54647.9
398,Velvet Throat,648,24,40,Venmo,,,,Personal,VENMO PAYMENT SENT TO ALEX SMITH FOR GUITAR REPAIR,-50.0,54597.9
399,Velvet Throat,649,27,40,PayPal,,,,Shopping,PAYPAL TRANSACTION TO AMAZON.COM ORDER #456789,-180.0,54417.9
400,Velvet Throat,650,30,40,ACH,,,,Loan,ACH DEBIT CAR LOAN PAYMENT TO CHASE AUTO FINANCE,-2000.0,52417.9
401,Velvet Throat,651,33,40,Debit Card,,,,Food & drink,POS PURCHASE #4567 WHOLE FOODS MARKET AZ,-130.5,52287.4
402,Velvet Throat,652,36,40,Apple Pay,,,,Health & Wellness,APPLE PAY TRANSACTION TO LULULEMON ATHLETICA,-99.95,52187.4
403,Velvet Throat,653,39,40,PayPal,,,,Entertainment,PAYPAL TRANSACTION TO NETFLIX.COM SUBSCRIPTION,-35.99,52151.4
404,Velvet Throat,654,42,40,Google Wallet,,,,Food & drink,GOOGLE WALLET TRANSACTION TO STARBUCKS COFFEE,-15.75,52135.7
405,Velvet Throat,655,45,40,Transfer,,,,Personal,TRANSFER TO SAVINGS ACCOUNT,-500.0,51635.7
406,Velvet Throat,656,48,40,Bill Pay,,,,Bills & utilities,BILL PAY AUTO DEBIT APS ELECTRICITY BILL AZ,-210.0,51425.7
407,Velvet Throat,657,51,40,Venmo,,,,Personal,VENMO PAYMENT SENT TO ALEX SMITH FOR GUITAR REPAIR,-50.0,51375.7
408,Velvet Throat,658,54,40,PayPal,,,,Shopping,PAYPAL TRANSACTION TO AMAZON.COM ORDER #456789,-180.0,51195.7
409,Velvet Throat,659,57,40,ACH,,,,Loan,ACH DEBIT CAR LOAN PAYMENT TO CHASE AUTO FINANCE,-2000.0,49195.7
410,Velvet Throat,660,60,40,Debit Card,,,,Food & drink,POS PURCHASE #4567 WHOLE FOODS MARKET AZ,-130.5,49065.2
411,Velvet Throat,661,63,40,Apple Pay,,,,Health & Wellness,APPLE PAY TRANSACTION TO LULULEMON ATHLETICA,-99.95,48965.2
412,Velvet Throat,662,66,40,PayPal,,,,Entertainment,PAYPAL TRANSACTION TO NETFLIX.COM SUBSCRIPTION,-35.99,48929.2
413,Velvet Throat,663,69,40,Google Wallet,,,,Food & drink,GOOGLE WALLET TRANSACTION TO STARBUCKS COFFEE,-15.75,48913.5
414,Velvet Throat,664,72,40,Transfer,,,,Personal,TRANSFER TO SAVINGS ACCOUNT,-500.0,48413.5
415,Velvet Throat,665,75,40,Bill Pay,,,,Bills & utilities,BILL PAY AUTO DEBIT APS ELECTRICITY BILL AZ,-210.0,48203.5
416,Velvet Throat,666,78,40,Venmo,,,,Personal,VENMO PAYMENT SENT TO ALEX SMITH FOR GUITAR REPAIR,-50.0,48153.5
417,Velvet Throat,667,81,40,PayPal,,,,Shopping,PAYPAL TRANSACTION TO AMAZON.COM ORDER #456789,-180.0,47973.5
418,Velvet Throat,668,84,40,ACH,,,,Loan,ACH DEBIT CAR LOAN PAYMENT TO CHASE AUTO FINANCE,-2000.0,45973.5
419,Velvet Throat,669,87,40,Debit Card,,,,Food & drink,POS PURCHASE #4567 WHOLE FOODS MARKET AZ,-130.5,45843.0
420,Velvet Throat,670,90,40,Apple Pay,,,,Health & Wellness,APPLE PAY TRANSACTION TO LULULEMON ATHLETICA,-99.95,45743.0
421,Velvet Throat,671,93,40,PayPal,,,,Entertainment,PAYPAL TRANSACTION TO NETFLIX.COM SUBSCRIPTION,-35.99,45707.0
422,Velvet Throat,672,1,41,Transfer,,,,Investment,TRANSFER TO VANGUARD ROTH IRA,-5000.0,15000.0
423,Velvet Throat,673,3,41,Wire,,,,Professional Services,OUTGOING WIRE TO SMITH AGENCY PUBLIC RELATIONS FEE,-1500.0,13500.0
424,Velvet Throat,674,4,41,ACH,,,,Employment,ACH CREDIT UNIVERSAL MUSIC GROUP ALBUM ROYALTIES,100000.0,113500.0
425,Velvet Throat,675,7,41,Venmo,,,,Gift & Donations,VENMO PAYMENT SENT TO CHARITY WATER DONATION,-150.0,113350.0
426,Velvet Throat,676,10,41,ACH,,,,Loan,ACH DEBIT CAR LOAN PAYMENT TO CHASE AUTO FINANCE,-2000.0,111350.0
427,Velvet Throat,677,13,41,Debit Card,,,,Gas,DEBIT CARD PURCHASE #5643 CHEVRON STATION AZ,-65.2,111285.0
428,Velvet Throat,678,16,41,Wire,,,,Professional Services,OUTGOING WIRE TO GOLDMAN LEGAL SERVICES RETAINER FEE,-3000.0,108285.0
429,Velvet Throat,679,19,41,ACH,,,,Investment,ACH CREDIT DIVIDEND RECEIPT FROM APPLE INC STOCKS,15000.0,123285.0
430,Velvet Throat,680,22,41,ACH,,,,Employment,ACH CREDIT DISNEY ROYALTIES FOR SECONDARY SCHOOL MUSICAL,85000.0,208285.0
431,Velvet Throat,681,25,41,Debit Card,,,,Entertainment,DEBIT CARD PURCHASE #7890 AMC THEATRES PREMIERE TICKETS,-75.0,208210.0
432,Velvet Throat,682,28,41,Check,,,,Home,CHECK #302 RENT PAYMENT FOR PHOENIX APARTMENT,-2500.0,205710.0
433,Velvet Throat,683,31,41,Bill Pay,,,,Bills & utilities,BILL PAY AUTO DEBIT CITY OF PHOENIX WATER BILL,-320.0,205390.0
434,Velvet Throat,684,34,41,ACH,,,,Benefits,ACH CREDIT SAG-AFTRA ROYALTIES FOR ONE PIECE,25000.0,230390.0
435,Velvet Throat,685,37,41,Transfer,,,,Investment,TRANSFER TO VANGUARD ROTH IRA,-5000.0,225390.0
436,Velvet Throat,686,40,41,Venmo,,,,Gift & Donations,VENMO PAYMENT SENT TO CHARITY WATER DONATION,-150.0,225240.0
437,Velvet Throat,687,43,41,Wire,,,,Professional Services,OUTGOING WIRE TO GOLDMAN LEGAL SERVICES RETAINER FEE,-3000.0,222240.0
438,Velvet Throat,688,46,41,ACH,,,,Investment,ACH CREDIT DIVIDEND RECEIPT FROM APPLE INC STOCKS,15000.0,237240.0
439,Velvet Throat,689,49,41,ACH,,,,Employment,ACH CREDIT DISNEY ROYALTIES FOR SECONDARY SCHOOL MUSICAL,85000.0,322240.0
440,Velvet Throat,690,52,41,Debit Card,,,,Entertainment,DEBIT CARD PURCHASE #7890 AMC THEATRES PREMIERE TICKETS,-75.0,322165.0
441,Velvet Throat,691,55,41,Check,,,,Home,CHECK #304 RENT PAYMENT FOR PHOENIX APARTMENT,-2500.0,319665.0
442,Velvet Throat,692,58,41,Bill Pay,,,,Bills & utilities,BILL PAY AUTO DEBIT CITY OF PHOENIX WATER BILL,-320.0,319345.0
443,Velvet Throat,693,61,41,ACH,,,,Benefits,ACH CREDIT SAG-AFTRA ROYALTIES FOR ONE PIECE,25000.0,344345.0
444,Velvet Throat,694,64,41,Transfer,,,,Investment,TRANSFER TO VANGUARD ROTH IRA,-5000.0,339345.0
445,Velvet Throat,695,67,41,Venmo,,,,Gift & Donations,VENMO PAYMENT SENT TO CHARITY WATER DONATION,-150.0,339195.0
446,Velvet Throat,696,70,41,Wire,,,,Professional Services,OUTGOING WIRE TO GOLDMAN LEGAL SERVICES RETAINER FEE,-3000.0,336195.0
447,Velvet Throat,697,73,41,ACH,,,,Investment,ACH CREDIT DIVIDEND RECEIPT FROM APPLE INC STOCKS,15000.0,351195.0
448,Velvet Throat,698,76,41,ACH,,,,Employment,ACH CREDIT DISNEY ROYALTIES FOR SECONDARY SCHOOL MUSICAL,85000.0,436195.0
449,Velvet Throat,699,79,41,Debit Card,,,,Entertainment,DEBIT CARD PURCHASE #7890 AMC THEATRES PREMIERE TICKETS,-75.0,436120.0
450,Velvet Throat,700,82,41,Check,,,,Home,CHECK #306 RENT PAYMENT FOR PHOENIX APARTMENT,-2500.0,433620.0
451,Velvet Throat,701,85,41,Bill Pay,,,,Bills & utilities,BILL PAY AUTO DEBIT CITY OF PHOENIX WATER BILL,-320.0,433300.0
452,Velvet Throat,702,88,41,ACH,,,,Benefits,ACH CREDIT SAG-AFTRA ROYALTIES FOR ONE PIECE,25000.0,458300.0
453,Velvet Throat,703,91,41,Transfer,,,,Investment,TRANSFER TO VANGUARD ROTH IRA,-5000.0,453300.0
454,Velvet Throat,704,2,42,Bill Pay,,,,Bills & utilities,BILL PAY AUTO DEBIT CITY OF PHOENIX WATER BILL,-320.0,199680.0
455,Velvet Throat,705,3,42,ACH,,,,Tax,ACH DEBIT IRS PAYMENT FOR 2023 Q3 ESTIMATED TAX,-7500.0,192180.0
456,Velvet Throat,706,5,42,Debit Card,,,,Shopping,DEBIT CARD PURCHASE #9876 NORDSTROM SCOTTSDALE AZ,-450.0,191730.0
457,Velvet Throat,707,8,42,Check,,,,Home,CHECK #301 RENT PAYMENT FOR PHOENIX APARTMENT,-2300.0,189430.0
458,Velvet Throat,708,11,42,Transfer,,,,Investment,TRANSFER TO CHARLES SCHWAB BROKERAGE ACCOUNT,-10000.0,179430.0
459,Velvet Throat,709,14,42,ACH,,,,Benefits,ACH CREDIT VIPGLOW ONLINE SALES DEPOSIT,5000.0,184430.0
460,Velvet Throat,710,17,42,Debit Card,,,,Shopping,DEBIT CARD PURCHASE #1122 SEPHORA COSMETICS AZ,-220.5,184210.0
461,Velvet Throat,711,20,42,Credit Card,,,,Travel,CREDIT CARD CHARGE FOR DELTA AIRLINES FLIGHT TO LA,-3200.0,181010.0
462,Velvet Throat,712,23,42,Transfer,,,,Loan,TRANSFER TO VIPGLOW BUSINESS LOAN REPAYMENT,-500.0,180510.0
463,Velvet Throat,713,26,42,ACH,,,,Benefits,ACH CREDIT VIPGLOW ONLINE SALES DEPOSIT,7500.0,188010.0
464,Velvet Throat,714,29,42,Wire,,,,Investment,OUTGOING WIRE TO GOLDMAN SACHS INVESTMENT ACCOUNT,-50000.0,138010.0
465,Velvet Throat,715,32,42,Transfer,,,,Investment,TRANSFER TO CHARLES SCHWAB BROKERAGE ACCOUNT,-10000.0,128010.0
466,Velvet Throat,716,35,42,Zelle,,,,Personal,ZELLE PAYMENT SENT TO JANE DOE FOR PIANO LESSONS,-250.0,127760.0
467,Velvet Throat,717,38,42,Debit Card,,,,Shopping,DEBIT CARD PURCHASE #9876 NORDSTROM SCOTTSDALE AZ,-480.0,127280.0
468,Velvet Throat,718,41,42,Check,,,,Home,CHECK #303 RENT PAYMENT FOR PHOENIX APARTMENT,-2300.0,124980.0
469,Velvet Throat,719,44,42,Debit Card,,,,Shopping,DEBIT CARD PURCHASE #1122 SEPHORA COSMETICS AZ,-220.5,124759.0
470,Velvet Throat,720,47,42,Credit Card,,,,Travel,CREDIT CARD CHARGE FOR DELTA AIRLINES FLIGHT TO LA,-3200.0,121559.0
471,Velvet Throat,721,50,42,Transfer,,,,Loan,TRANSFER TO VIPGLOW BUSINESS LOAN REPAYMENT,-500.0,121059.0
472,Velvet Throat,722,53,42,ACH,,,,Benefits,ACH CREDIT VIPGLOW ONLINE SALES DEPOSIT,7500.0,128559.0
473,Velvet Throat,723,56,42,Wire,,,,Investment,OUTGOING WIRE TO GOLDMAN SACHS INVESTMENT ACCOUNT,-50000.0,78559.0
474,Velvet Throat,724,59,42,Transfer,,,,Investment,TRANSFER TO CHARLES SCHWAB BROKERAGE ACCOUNT,-10000.0,68559.0
475,Velvet Throat,725,62,42,Zelle,,,,Personal,ZELLE PAYMENT SENT TO JANE DOE FOR PIANO LESSONS,-250.0,68309.0
476,Velvet Throat,726,65,42,Debit Card,,,,Shopping,DEBIT CARD PURCHASE #9876 NORDSTROM SCOTTSDALE AZ,-480.0,67829.0
477,Velvet Throat,727,68,42,Check,,,,Home,CHECK #305 RENT PAYMENT FOR PHOENIX APARTMENT,-2300.0,65529.0
478,Velvet Throat,728,71,42,Debit Card,,,,Shopping,DEBIT CARD PURCHASE #1122 SEPHORA COSMETICS AZ,-220.5,65308.5
479,Velvet Throat,729,74,42,Credit Card,,,,Travel,CREDIT CARD CHARGE FOR DELTA AIRLINES FLIGHT TO LA,-3200.0,62108.5
480,Velvet Throat,730,77,42,Transfer,,,,Loan,TRANSFER TO VIPGLOW BUSINESS LOAN REPAYMENT,-500.0,61608.5
481,Velvet Throat,731,80,42,ACH,,,,Benefits,ACH CREDIT VIPGLOW ONLINE SALES DEPOSIT,7500.0,69108.5
482,Velvet Throat,732,83,42,Wire,,,,Investment,OUTGOING WIRE TO GOLDMAN SACHS INVESTMENT ACCOUNT,-50000.0,19108.5
483,Velvet Throat,733,86,42,Transfer,,,,Investment,TRANSFER TO CHARLES SCHWAB BROKERAGE ACCOUNT,-10000.0,9108.5
484,Velvet Throat,734,89,42,Zelle,,,,Personal,ZELLE PAYMENT SENT TO JANE DOE FOR PIANO LESSONS,-250.0,8858.5
485,Velvet Throat,735,92,42,Debit Card,,,,Shopping,DEBIT CARD PURCHASE #9876 NORDSTROM SCOTTSDALE AZ,-480.0,8378.5
486,Jared Livinglife,387,1,36,ACH,,,,Benefits,ACH CREDIT SSA TREAS 310 XXSOC SEC,1200.0,30200.0
487,Jared Livinglife,388,2,36,Debit Card,,,,Food & drink,POS PURCHASE #9876 WHOLE FOODS MARKET CA,-45.67,30154.3
488,Jared Livinglife,389,3,36,Bill Pay,,,,Bills & utilities,BILL PAY AUTO DEBIT PG&E SAN FRANCISCO UTILITY BILL,-112.55,30041.8
489,Jared Livinglife,390,5,36,Transfer,,,,Transfer,ONLINE TRANSFER TO SAVINGS ACCOUNT #987654321,-200.0,29841.8
490,Jared Livinglife,391,7,36,Debit Card,,,,Gas,POS PURCHASE #4567 CHEVRON SAN RAMON CA,-63.29,29778.5
491,Jared Livinglife,392,8,36,Debit Card,,,,Entertainment,POS PURCHASE #1234 AMC THEATRES ONLINE TICKET,-30.0,29748.5
492,Jared Livinglife,393,10,36,Debit Card,,,,Shopping,POS PURCHASE #8523 TARGET SAN RAMON CA,-85.9,29662.6
493,Jared Livinglife,394,12,36,Debit Card,,,,Health & Wellness,POS PURCHASE #9632 WALGREENS SAN RAMON,-20.0,29642.6
494,Jared Livinglife,395,14,36,ACH,,,,Donations,ACH DEBIT DONATION TO RED CROSS,-50.0,29592.6
495,Jared Livinglife,396,15,36,ACH,,,,Benefits,ACH CREDIT SSA TREAS 310 XXSOC SEC,1200.0,30792.6
496,Jared Livinglife,397,16,36,Debit Card,,,,Food & drink,POS PURCHASE #2034 STARBUCKS SAN RAMON CA,-9.75,30782.8
497,Jared Livinglife,398,18,36,Debit Card,,,,Grocieries,POS PURCHASE #5678 SAFEWAY SAN RAMON CA,-110.47,30672.4
498,Jared Livinglife,399,20,36,Debit Card,,,,Personal,POS PURCHASE #7890 PETSMART DOG FOOD,-60.0,30612.4
499,Jared Livinglife,400,22,36,Debit Card,,,,Travel,POS PURCHASE #3210 SOUTHWEST AIRLINES TICKET,-250.0,30362.4
500,Jared Livinglife,401,23,36,Debit Card,,,,Food & drink,POS PURCHASE #6543 OLIVE GARDEN SAN RAMON CA,-35.6,30326.8
501,Jared Livinglife,402,25,36,Debit Card,,,,Shopping,POS PURCHASE #8529 COSTCO WHSE SAN RAMON CA,-180.0,30146.8
502,Jared Livinglife,403,27,36,Debit Card,,,,Entertainment,POS PURCHASE #1235 NETFLIX SUBSCRIPTION,-15.0,30131.8
503,Jared Livinglife,404,29,36,Debit Card,,,,Health & Wellness,POS PURCHASE #9633 CVS PHARMACY SAN RAMON CA,-40.0,30091.8
504,Jared Livinglife,405,31,36,Bill Pay,,,,Bills & utilities,BILL PAY AUTO DEBIT PG&E SAN FRANCISCO UTILITY BILL,-112.55,29979.2
505,Jared Livinglife,406,32,36,ACH,,,,Benefits,ACH CREDIT SSA TREAS 310 XXSOC SEC,1200.0,31179.2
506,Jared Livinglife,407,33,36,Debit Card,,,,Food & drink,POS PURCHASE #9876 WHOLE FOODS MARKET CA,-50.32,31128.9
507,Jared Livinglife,408,34,36,Transfer,,,,Transfer,ONLINE TRANSFER TO SAVINGS ACCOUNT #987654321,-200.0,30928.9
508,Jared Livinglife,409,36,36,Debit Card,,,,Gas,POS PURCHASE #4567 CHEVRON SAN RAMON CA,-65.0,30863.9
509,Jared Livinglife,410,38,36,Debit Card,,,,Entertainment,POS PURCHASE #1234 AMC THEATRES ONLINE TICKET,-50.0,30813.9
510,Jared Livinglife,411,40,36,Debit Card,,,,Shopping,POS PURCHASE #8523 TARGET SAN RAMON CA,-90.45,30723.4
511,Jared Livinglife,412,42,36,Debit Card,,,,Health & Wellness,POS PURCHASE #9632 WALGREENS SAN RAMON,-25.0,30698.4
512,Jared Livinglife,413,44,36,ACH,,,,Donations,ACH DEBIT DONATION TO HABITAT FOR HUMANITY,-100.0,30598.4
513,Jared Livinglife,414,46,36,ACH,,,,Benefits,ACH CREDIT SSA TREAS 310 XXSOC SEC,1200.0,31798.4
514,Jared Livinglife,415,48,36,Debit Card,,,,Food & drink,POS PURCHASE #2034 STARBUCKS SAN RAMON CA,-12.0,31786.4
515,Jared Livinglife,416,50,36,Debit Card,,,,Grocieries,POS PURCHASE #5678 SAFEWAY SAN RAMON CA,-115.22,31671.2
516,Jared Livinglife,417,52,36,Debit Card,,,,Personal,POS PURCHASE #7890 PETSMART DOG SUPPLIES,-80.0,31591.2
517,Jared Livinglife,418,54,36,Debit Card,,,,Travel,POS PURCHASE #3210 SOUTHWEST AIRLINES TICKET,-300.0,31291.2
518,Jared Livinglife,419,56,36,Debit Card,,,,Food & drink,POS PURCHASE #6543 OLIVE GARDEN SAN RAMON CA,-40.75,31250.5
519,Jared Livinglife,420,58,36,Debit Card,,,,Shopping,POS PURCHASE #8529 COSTCO WHSE SAN RAMON CA,-200.0,31050.5
520,Jared Livinglife,421,60,36,Debit Card,,,,Entertainment,POS PURCHASE #1235 NETFLIX SUBSCRIPTION,-20.0,31030.5
521,Jared Livinglife,422,61,36,Bill Pay,,,,Bills & utilities,BILL PAY AUTO DEBIT PG&E SAN FRANCISCO UTILITY BILL,-112.55,30917.9
522,Jared Livinglife,423,62,36,ACH,,,,Benefits,ACH CREDIT SSA TREAS 310 XXSOC SEC,1200.0,32117.9
523,Jared Livinglife,424,63,36,Debit Card,,,,Food & drink,POS PURCHASE #9876 WHOLE FOODS MARKET CA,-55.1,32062.8
524,Jared Livinglife,425,64,36,Transfer,,,,Transfer,ONLINE TRANSFER TO SAVINGS ACCOUNT #987654321,-200.0,31862.8
525,Jared Livinglife,426,66,36,Debit Card,,,,Gas,POS PURCHASE #4567 CHEVRON SAN RAMON CA,-70.0,31792.8
526,Jared Livinglife,427,68,36,Debit Card,,,,Entertainment,POS PURCHASE #1234 AMC THEATRES ONLINE TICKET,-60.0,31732.8
527,Jared Livinglife,428,70,36,Debit Card,,,,Shopping,POS PURCHASE #8523 TARGET SAN RAMON CA,-95.0,31637.8
528,Jared Livinglife,429,72,36,Debit Card,,,,Health & Wellness,POS PURCHASE #9632 WALGREENS SAN RAMON,-30.0,31607.8
529,Jared Livinglife,430,74,36,ACH,,,,Donations,ACH DEBIT DONATION TO ST JUDE CHILDREN'S HOSPITAL,-150.0,31457.8
530,Jared Livinglife,431,76,36,ACH,,,,Benefits,ACH CREDIT SSA TREAS 310 XXSOC SEC,1200.0,32657.8
531,Jared Livinglife,432,78,36,Debit Card,,,,Food & drink,POS PURCHASE #2034 STARBUCKS SAN RAMON CA,-14.25,32643.6
532,Jared Livinglife,433,80,36,Debit Card,,,,Grocieries,POS PURCHASE #5678 SAFEWAY SAN RAMON CA,-120.0,32523.6
533,Jared Livinglife,434,82,36,Debit Card,,,,Personal,POS PURCHASE #7890 PETSMART DOG GROOMING,-100.0,32423.6
534,Jared Livinglife,435,84,36,Debit Card,,,,Travel,POS PURCHASE #3210 SOUTHWEST AIRLINES TICKET,-350.0,32073.6
535,Jared Livinglife,436,86,36,Debit Card,,,,Food & drink,POS PURCHASE #6543 OLIVE GARDEN SAN RAMON CA,-45.9,32027.7
536,Jared Livinglife,437,88,36,Debit Card,,,,Shopping,POS PURCHASE #8529 COSTCO WHSE SAN RAMON CA,-220.0,31807.7
537,Jared Livinglife,438,90,36,Debit Card,,,,Entertainment,POS PURCHASE #1235 NETFLIX SUBSCRIPTION,-25.0,31782.7
538,Jared Livinglife,439,92,36,Bill Pay,,,,Bills & utilities,BILL PAY AUTO DEBIT PG&E SAN FRANCISCO UTILITY BILL,-112.55,31670.1
539,Jared Livinglife,440,93,36,ACH,,,,Benefits,ACH CREDIT SSA TREAS 310 XXSOC SEC,1200.0,32870.1
540,Jared Livinglife,441,5,37,Transfer,,,,Transfer,ONLINE TRANSFER FROM CHECKING ACCOUNT #456789123,200.0,10200.0
541,Jared Livinglife,442,34,37,Transfer,,,,Transfer,ONLINE TRANSFER FROM CHECKING ACCOUNT #456789123,200.0,10400.0
542,Jared Livinglife,443,64,37,Transfer,,,,Transfer,ONLINE TRANSFER FROM CHECKING ACCOUNT #456789123,200.0,10600.0
543,Aphrodite Greek,101,1,31,ACH,,,,Bills & utilities,BILL PAY AUTO DEBIT PG&E SAN FRANCISCO UTILITY BILL,-120.0,99880.0
544,Aphrodite Greek,102,1,31,Debit Card,,,,Food & drink,POS PURCHASE #4567 WHOLE FOODS MARKET SF,-35.75,99844.2
545,Aphrodite Greek,103,2,31,Transfer,,,,Investment,TRANSFER TO SAVINGS FOR INVESTMENT,-500.0,99344.2
546,Aphrodite Greek,104,3,31,Debit Card,,,,Shopping,POS PURCHASE #7890 MICHAELS CRAFTS SF,-210.5,99133.8
547,Aphrodite Greek,105,4,31,Wire,,,,Professional Services,OUTGOING WIRE TO BEAD SUPPLIER INC FOR INVENTORY,-300.0,98833.8
548,Aphrodite Greek,106,5,31,Debit Card,,,,Entertainment,POS PURCHASE #1234 AMC THEATRES ONLINE TICKETING,-89.99,98743.8
549,Aphrodite Greek,107,6,31,Debit Card,,,,Gas,POS PURCHASE #4567 CHEVRON SF,-65.0,98678.8
550,Aphrodite Greek,108,7,31,ACH,,,,Loan,ACH AUTO DEBIT STUDENT LOAN PAYMENT,-250.0,98428.8
551,Aphrodite Greek,109,8,31,Debit Card,,,,Grocieries,POS PURCHASE #7890 SAFEWAY STORES SF,-110.45,98318.3
552,Aphrodite Greek,110,9,31,Transfer,,,,Transfer,TRANSFER TO SAVINGS ACCOUNT #1023456789,-1000.0,97318.3
553,Aphrodite Greek,111,10,31,ACH,,,,Employment,ACH DEBIT MONTHLY ETSY SELLER FEES,-50.0,97268.3
554,Aphrodite Greek,112,11,31,Debit Card,,,,Food & drink,POS PURCHASE #2034 STARBUCKS SF,-12.0,97256.3
555,Aphrodite Greek,113,12,31,Debit Card,,,,Health & Wellness,POS PURCHASE #4567 CVS PHARMACY SF,-60.0,97196.3
556,Aphrodite Greek,114,13,31,Debit Card,,,,Shopping,POS PURCHASE #7890 TARGET ONLINE SHOPPING,-150.0,97046.3
557,Aphrodite Greek,115,14,31,ACH,,,,Tax,ACH DEBIT QUARTERLY STATE TAX PAYMENT,-300.0,96746.3
558,Aphrodite Greek,116,15,31,Debit Card,,,,Travel,POS PURCHASE #1234 UNITED AIRLINES TICKETING,-500.0,96246.3
559,Aphrodite Greek,117,16,31,Debit Card,,,,Food & drink,POS PURCHASE #4567 CHIPOTLE ONLINE ORDER SF,-40.0,96206.3
560,Aphrodite Greek,118,17,31,ACH,,,,Bills & utilities,BILL PAY AUTO DEBIT COMCAST SAN FRANCISCO INTERNET BILL,-80.0,96126.3
561,Aphrodite Greek,119,18,31,Debit Card,,,,Entertainment,POS PURCHASE #7890 SPOTIFY SUBSCRIPTION,-25.0,96101.3
562,Aphrodite Greek,120,19,31,Debit Card,,,,Shopping,POS PURCHASE #1234 ETSY SUPPLIES ORDER,-220.0,95881.3
563,Aphrodite Greek,121,20,31,Debit Card,,,,Food & drink,POS PURCHASE #4567 PEET'S COFFEE SF,-15.0,95866.3
564,Aphrodite Greek,122,21,31,Debit Card,,,,Gas,POS PURCHASE #7890 SHELL GAS STATION SF,-70.0,95796.3
565,Aphrodite Greek,123,22,31,ACH,,,,Loan,ACH AUTO DEBIT CAR LOAN PAYMENT,-250.0,95546.3
566,Aphrodite Greek,124,23,31,Debit Card,,,,Shopping,POS PURCHASE #1234 AMAZON MKTPLACE PMTS,-180.0,95366.3
567,Aphrodite Greek,125,24,31,Debit Card,,,,Food & drink,POS PURCHASE #4567 OLIVE GARDEN SF,-50.0,95316.3
568,Aphrodite Greek,126,25,31,Debit Card,,,,Health & Wellness,POS PURCHASE #7890 24 HOUR FITNESS MEMBERSHIP,-100.0,95216.3
569,Aphrodite Greek,127,26,31,Debit Card,,,,Shopping,POS PURCHASE #1234 NORDSTROM SF,-75.0,95141.3
570,Aphrodite Greek,128,27,31,Debit Card,,,,Food & drink,POS PURCHASE #4567 DOMINO'S PIZZA ONLINE ORDER SF,-30.0,95111.3
571,Aphrodite Greek,129,28,31,Debit Card,,,,Gas,POS PURCHASE #7890 TEXACO GAS STATION SF,-62.0,95049.3
572,Aphrodite Greek,130,29,31,ACH,,,,Bills & utilities,BILL PAY AUTO DEBIT PG&E SAN FRANCISCO UTILITY BILL,-120.0,94929.3
573,Aphrodite Greek,131,30,31,Debit Card,,,,Food & drink,POS PURCHASE #1234 WHOLE FOODS MARKET SF,-35.75,94893.6
574,Aphrodite Greek,132,31,31,Transfer,,,,Investment,TRANSFER TO SAVINGS FOR INVESTMENT,-500.0,94393.6
575,Aphrodite Greek,133,33,31,Debit Card,,,,Shopping,POS PURCHASE #4567 MICHAELS CRAFTS SF,-210.5,94183.1
576,Aphrodite Greek,134,34,31,Wire,,,,Professional Services,OUTGOING WIRE TO BEAD SUPPLIER INC FOR INVENTORY,-300.0,93883.1
577,Aphrodite Greek,135,35,31,Debit Card,,,,Entertainment,POS PURCHASE #7890 AMC THEATRES ONLINE TICKETING,-89.99,93793.1
578,Aphrodite Greek,136,36,31,Debit Card,,,,Gas,POS PURCHASE #1234 CHEVRON SF,-65.0,93728.1
579,Aphrodite Greek,137,37,31,ACH,,,,Loan,ACH AUTO DEBIT STUDENT LOAN PAYMENT,-250.0,93478.1
580,Aphrodite Greek,138,38,31,Debit Card,,,,Grocieries,POS PURCHASE #4567 SAFEWAY STORES SF,-110.45,93367.6
581,Aphrodite Greek,139,39,31,Transfer,,,,Transfer,TRANSFER TO SAVINGS ACCOUNT #1023456789,-1000.0,92367.6
582,Aphrodite Greek,140,40,31,ACH,,,,Employment,ACH DEBIT MONTHLY ETSY SELLER FEES,-50.0,92317.6
583,Aphrodite Greek,141,41,31,Debit Card,,,,Food & drink,POS PURCHASE #7890 STARBUCKS SF,-12.0,92305.6
584,Aphrodite Greek,142,42,31,Debit Card,,,,Health & Wellness,POS PURCHASE #1234 CVS PHARMACY SF,-60.0,92245.6
585,Aphrodite Greek,143,43,31,Debit Card,,,,Shopping,POS PURCHASE #4567 TARGET ONLINE SHOPPING,-150.0,92095.6
586,Aphrodite Greek,144,44,31,ACH,,,,Tax,ACH DEBIT QUARTERLY STATE TAX PAYMENT,-300.0,91795.6
587,Aphrodite Greek,145,45,31,Debit Card,,,,Travel,POS PURCHASE #7890 UNITED AIRLINES TICKETING,-500.0,91295.6
588,Aphrodite Greek,146,46,31,Debit Card,,,,Food & drink,POS PURCHASE #1234 CHIPOTLE ONLINE ORDER SF,-40.0,91255.6
589,Aphrodite Greek,147,47,31,ACH,,,,Bills & utilities,BILL PAY AUTO DEBIT COMCAST SAN FRANCISCO INTERNET BILL,-80.0,91175.6
590,Aphrodite Greek,148,48,31,Debit Card,,,,Entertainment,POS PURCHASE #4567 SPOTIFY SUBSCRIPTION,-25.0,91150.6
591,Aphrodite Greek,149,49,31,Debit Card,,,,Shopping,POS PURCHASE #7890 ETSY SUPPLIES ORDER,-220.0,90930.6
592,Aphrodite Greek,150,50,31,Debit Card,,,,Food & drink,POS PURCHASE #1234 PEET'S COFFEE SF,-15.0,90915.6
593,Aphrodite Greek,151,51,31,Debit Card,,,,Gas,POS PURCHASE #4567 SHELL GAS STATION SF,-70.0,90845.6
594,Aphrodite Greek,152,52,31,ACH,,,,Loan,ACH AUTO DEBIT CAR LOAN PAYMENT,-250.0,90595.6
595,Aphrodite Greek,153,53,31,Debit Card,,,,Shopping,POS PURCHASE #7890 AMAZON MKTPLACE PMTS,-180.0,90415.6
596,Aphrodite Greek,154,54,31,Debit Card,,,,Food & drink,POS PURCHASE #1234 OLIVE GARDEN SF,-50.0,90365.6
597,Aphrodite Greek,155,55,31,Debit Card,,,,Health & Wellness,POS PURCHASE #4567 24 HOUR FITNESS MEMBERSHIP,-100.0,90265.6
598,Aphrodite Greek,156,56,31,Debit Card,,,,Shopping,POS PURCHASE #7890 NORDSTROM SF,-75.0,90190.6
599,Aphrodite Greek,157,57,31,Debit Card,,,,Food & drink,POS PURCHASE #1234 DOMINO'S PIZZA ONLINE ORDER SF,-30.0,90160.6
600,Aphrodite Greek,158,58,31,Debit Card,,,,Gas,POS PURCHASE #4567 TEXACO GAS STATION SF,-62.0,90098.6
601,Aphrodite Greek,159,59,31,ACH,,,,Bills & utilities,BILL PAY AUTO DEBIT PG&E SAN FRANCISCO UTILITY BILL,-120.0,89978.6
602,Aphrodite Greek,160,60,31,Debit Card,,,,Food & drink,POS PURCHASE #7890 WHOLE FOODS MARKET SF,-35.75,89942.9
603,Aphrodite Greek,161,61,31,Transfer,,,,Investment,TRANSFER TO SAVINGS FOR INVESTMENT,-500.0,89442.9
604,Aphrodite Greek,162,63,31,Debit Card,,,,Shopping,POS PURCHASE #1234 MICHAELS CRAFTS SF,-210.5,89232.4
605,Aphrodite Greek,163,64,31,Wire,,,,Professional Services,OUTGOING WIRE TO BEAD SUPPLIER INC FOR INVENTORY,-300.0,88932.4
606,Aphrodite Greek,164,65,31,Debit Card,,,,Entertainment,POS PURCHASE #4567 AMC THEATRES ONLINE TICKETING,-89.99,88842.4
607,Aphrodite Greek,165,66,31,Debit Card,,,,Gas,POS PURCHASE #7890 CHEVRON SF,-65.0,88777.4
608,Aphrodite Greek,166,67,31,ACH,,,,Loan,ACH AUTO DEBIT STUDENT LOAN PAYMENT,-250.0,88527.4
609,Aphrodite Greek,167,68,31,Debit Card,,,,Grocieries,POS PURCHASE #1234 SAFEWAY STORES SF,-110.45,88416.9
610,Aphrodite Greek,168,69,31,Transfer,,,,Transfer,TRANSFER TO SAVINGS ACCOUNT #1023456789,-1000.0,87416.9
611,Aphrodite Greek,169,70,31,ACH,,,,Employment,ACH DEBIT MONTHLY ETSY SELLER FEES,-50.0,87366.9
612,Aphrodite Greek,170,71,31,Debit Card,,,,Food & drink,POS PURCHASE #4567 STARBUCKS SF,-12.0,87354.9
613,Aphrodite Greek,171,72,31,Debit Card,,,,Health & Wellness,POS PURCHASE #7890 CVS PHARMACY SF,-60.0,87294.9
614,Aphrodite Greek,172,73,31,Debit Card,,,,Shopping,POS PURCHASE #1234 TARGET ONLINE SHOPPING,-150.0,87144.9
615,Aphrodite Greek,173,74,31,ACH,,,,Tax,ACH DEBIT QUARTERLY STATE TAX PAYMENT,-300.0,86844.9
616,Aphrodite Greek,174,75,31,Debit Card,,,,Travel,POS PURCHASE #4567 UNITED AIRLINES TICKETING,-500.0,86344.9
617,Aphrodite Greek,175,76,31,Debit Card,,,,Food & drink,POS PURCHASE #7890 CHIPOTLE ONLINE ORDER SF,-40.0,86304.9
618,Aphrodite Greek,176,77,31,ACH,,,,Bills & utilities,BILL PAY AUTO DEBIT COMCAST SAN FRANCISCO INTERNET BILL,-80.0,86224.9
619,Aphrodite Greek,177,78,31,Debit Card,,,,Entertainment,POS PURCHASE #1234 SPOTIFY SUBSCRIPTION,-25.0,86199.9
620,Aphrodite Greek,178,79,31,Debit Card,,,,Shopping,POS PURCHASE #4567 ETSY SUPPLIES ORDER,-220.0,85979.9
621,Aphrodite Greek,179,80,31,Debit Card,,,,Food & drink,POS PURCHASE #7890 PEET'S COFFEE SF,-15.0,85964.9
622,Aphrodite Greek,180,81,31,Debit Card,,,,Gas,POS PURCHASE #1234 SHELL GAS STATION SF,-70.0,85894.9
623,Aphrodite Greek,181,82,31,ACH,,,,Loan,ACH AUTO DEBIT CAR LOAN PAYMENT,-250.0,85644.9
624,Aphrodite Greek,182,83,31,Debit Card,,,,Shopping,POS PURCHASE #4567 AMAZON MKTPLACE PMTS,-180.0,85464.9
625,Aphrodite Greek,183,84,31,Debit Card,,,,Food & drink,POS PURCHASE #7890 OLIVE GARDEN SF,-50.0,85414.9
626,Aphrodite Greek,184,85,31,Debit Card,,,,Health & Wellness,POS PURCHASE #1234 24 HOUR FITNESS MEMBERSHIP,-100.0,85314.9
627,Aphrodite Greek,185,86,31,Debit Card,,,,Shopping,POS PURCHASE #4567 NORDSTROM SF,-75.0,85239.9
628,Aphrodite Greek,186,87,31,Debit Card,,,,Food & drink,POS PURCHASE #7890 DOMINO'S PIZZA ONLINE ORDER SF,-30.0,85209.9
629,Aphrodite Greek,187,88,31,Debit Card,,,,Gas,POS PURCHASE #1234 TEXACO GAS STATION SF,-62.0,85147.9
630,Aphrodite Greek,188,89,31,ACH,,,,Bills & utilities,BILL PAY AUTO DEBIT PG&E SAN FRANCISCO UTILITY BILL,-120.0,85027.9
631,Aphrodite Greek,189,90,31,Debit Card,,,,Food & drink,POS PURCHASE #4567 WHOLE FOODS MARKET SF,-35.75,84992.2
632,Aphrodite Greek,190,91,31,Transfer,,,,Investment,TRANSFER TO SAVINGS FOR INVESTMENT,-500.0,84492.2
633,Aphrodite Greek,191,93,31,Debit Card,,,,Shopping,POS PURCHASE #7890 MICHAELS CRAFTS SF,-210.5,84281.7
634,Aphrodite Greek,192,2,32,ACH,,,,Benefits,ACH CREDIT ETSY APHRODITE GREEK JEWELRY SALES,1500.0,11500.0
635,Aphrodite Greek,193,32,32,ACH,,,,Benefits,ACH CREDIT ETSY APHRODITE GREEK JEWELRY SALES,1500.0,13000.0
636,Aphrodite Greek,194,62,32,ACH,,,,Benefits,ACH CREDIT ETSY APHRODITE GREEK JEWELRY SALES,1500.0,14500.0
637,Aphrodite Greek,195,92,32,ACH,,,,Benefits,ACH CREDIT ETSY APHRODITE GREEK JEWELRY SALES,1500.0,16000.0
638,Helen Troy,290,1,35,ACH,,,,Benefits,ACH CREDIT MODELLING AGENCY PAYMENT RECEIVED,5000.0,205000.0
639,Helen Troy,291,1,35,Credit Card,,,,Shopping,POS PURCHASE #9876 GUCCI BEVERLY HILLS,-1500.0,203500.0
640,Helen Troy,292,2,35,Transfer,,,,Investment,TRANSFER TO VANGUARD INVESTMENT ACCOUNT,-20000.0,183500.0
641,Helen Troy,293,2,35,Bill Pay,,,,Bills & utilities,BILL PAY AUTO DEBIT SOUTHERN CALIFORNIA EDISON ELECTRIC BILL,-250.0,183250.0
642,Helen Troy,294,3,35,Debit Card,,,,Food & drink,POS PURCHASE #4567 WHOLE FOODS MARKET PASADENA,-120.0,183130.0
643,Helen Troy,295,3,35,Zelle,,,,Gift & Donations,INCOMING ZELLE FROM JANE DOE FOR CHARITY EVENT,1000.0,184130.0
644,Helen Troy,296,4,35,Wire,,,,Donations,OUTGOING WIRE TO DOMESTIC ABUSE FOUNDATION DONATION,-5000.0,179130.0
645,Helen Troy,297,5,35,ACH,,,,Employment,ACH CREDIT CITY COUNCIL MONTHLY STIPEND,3000.0,182130.0
646,Helen Troy,298,5,35,Debit Card,,,,Entertainment,POS PURCHASE #1234 AMC THEATRES ARCADIA,-200.0,181930.0
647,Helen Troy,299,6,35,Debit Card,,,,Gas,POS PURCHASE #7890 CHEVRON ARCADIA,-75.0,181855.0
648,Helen Troy,300,7,35,Transfer,,,,Loan,TRANSFER TO CAR LOAN ACCOUNT PAYMENT,-1500.0,180355.0
649,Helen Troy,301,8,35,Debit Card,,,,Grocieries,POS PURCHASE #6543 TRADER JOE'S PASADENA,-250.0,180105.0
650,Helen Troy,302,9,35,Apple Pay,,,,Health & Wellness,APPLE PAY PURCHASE #3214 EQUINOX GYM MEMBERSHIP,-350.0,179755.0
651,Helen Troy,303,10,35,Check,,,,Tax,CHECK #98765 PAYMENT TO IRS FOR QUARTERLY TAXES,-10000.0,169755.0
652,Helen Troy,304,11,35,ACH,,,,Donations,ACH DEBIT MONTHLY DONATION TO WOMEN'S SHELTER,-1500.0,168255.0
653,Helen Troy,305,12,35,Debit Card,,,,Travel,POS PURCHASE #8523 DELTA AIRLINES FLIGHT TO NY,-3000.0,165255.0
654,Helen Troy,306,13,35,Debit Card,,,,Shopping,POS PURCHASE #9630 NORDSTROM GLENDALE,-750.0,164505.0
655,Helen Troy,307,14,35,Transfer,,,,Home,TRANSFER TO MORTGAGE PAYMENT WELLS FARGO HOME MORTGAGE,-5000.0,159505.0
656,Helen Troy,308,15,35,Debit Card,,,,Food & drink,POS PURCHASE #2468 THE CHEESECAKE FACTORY PASADENA,-180.0,159325.0
657,Helen Troy,309,16,35,ACH,,,,Benefits,ACH CREDIT MODELLING AGENCY PAYMENT RECEIVED,5000.0,164325.0
658,Helen Troy,310,17,35,Google Wallet,,,,Entertainment,GOOGLE WALLET PURCHASE #7531 NETFLIX MONTHLY SUBSCRIPTION,-100.0,164225.0
659,Helen Troy,311,18,35,Debit Card,,,,Food & drink,POS PURCHASE #1593 STARBUCKS PASADENA,-90.0,164135.0
660,Helen Troy,312,19,35,Transfer,,,,Investment,TRANSFER TO CHARLES SCHWAB INVESTMENT ACCOUNT,-20000.0,144135.0
661,Helen Troy,313,20,35,Debit Card,,,,Shopping,POS PURCHASE #3579 APPLE STORE GLENDALE,-450.0,143685.0
662,Helen Troy,314,21,35,ACH,,,,Donations,ACH DEBIT MONTHLY DONATION TO SAVE THE CHILDREN FUND,-2000.0,141685.0
663,Helen Troy,315,22,35,Debit Card,,,,Health & Wellness,POS PURCHASE #4680 CVS PHARMACY ARCADIA,-100.0,141585.0
664,Helen Troy,316,23,35,PayPal,,,,Professional Services,PAYPAL PAYMENT TO SMITH MARKETING SERVICES,-500.0,141085.0
665,Helen Troy,317,24,35,Debit Card,,,,Food & drink,POS PURCHASE #5791 IN-N-OUT BURGER PASADENA,-130.0,140955.0
666,Helen Troy,318,25,35,Transfer,,,,Loan,TRANSFER TO CAR LOAN ACCOUNT PAYMENT,-1500.0,139455.0
667,Helen Troy,319,26,35,Debit Card,,,,Entertainment,POS PURCHASE #6802 TICKETMASTER CONCERT TICKETS,-250.0,139205.0
668,Helen Troy,320,27,35,Debit Card,,,,Travel,POS PURCHASE #7913 UBER RIDE TO LAX AIRPORT,-500.0,138705.0
669,Helen Troy,321,28,35,ACH,,,,Employment,ACH CREDIT CITY COUNCIL MONTHLY STIPEND,3000.0,141705.0
670,Helen Troy,322,29,35,Debit Card,,,,Shopping,POS PURCHASE #9024 TIFFANY & CO PASADENA,-1200.0,140505.0
671,Helen Troy,323,30,35,Debit Card,,,,Gas,POS PURCHASE #0135 ARCO GAS STATION ARCADIA,-80.0,140425.0
672,Helen Troy,324,31,35,Bill Pay,,,,Bills & utilities,BILL PAY AUTO DEBIT AT&T WIRELESS PHONE BILL,-300.0,140125.0
673,Helen Troy,325,32,35,ACH,,,,Benefits,ACH CREDIT MODELLING AGENCY PAYMENT RECEIVED,5000.0,145125.0
674,Helen Troy,326,33,35,Credit Card,,,,Shopping,POS PURCHASE #0246 LOUIS VUITTON BEVERLY HILLS,-1800.0,143325.0
675,Helen Troy,327,34,35,Transfer,,,,Investment,TRANSFER TO FIDELITY INVESTMENT ACCOUNT,-20000.0,123325.0
676,Helen Troy,328,35,35,Bill Pay,,,,Bills & utilities,BILL PAY AUTO DEBIT SOUTHERN CALIFORNIA GAS COMPANY GAS BILL,-250.0,123075.0
677,Helen Troy,329,36,35,Debit Card,,,,Food & drink,POS PURCHASE #0357 RALPHS GROCERY STORE PASADENA,-110.0,122965.0
678,Helen Troy,330,37,35,Zelle,,,,Gift & Donations,INCOMING ZELLE FROM MICHAEL SMITH FOR CHARITY GALA,1500.0,124465.0
679,Helen Troy,331,38,35,Wire,,,,Donations,OUTGOING WIRE TO DOMESTIC ABUSE FOUNDATION DONATION,-6000.0,118465.0
680,Helen Troy,332,39,35,ACH,,,,Employment,ACH CREDIT CITY COUNCIL MONTHLY STIPEND,3000.0,121465.0
681,Helen Troy,333,40,35,Debit Card,,,,Entertainment,POS PURCHASE #0468 REGAL CINEMAS ARCADIA,-220.0,121245.0
682,Helen Troy,334,41,35,Debit Card,,,,Gas,POS PURCHASE #0579 MOBIL GAS STATION ARCADIA,-70.0,121175.0
683,Helen Troy,335,42,35,Transfer,,,,Home,TRANSFER TO MORTGAGE PAYMENT CHASE HOME FINANCE,-5000.0,116175.0
684,Helen Troy,336,43,35,Debit Card,,,,Grocieries,POS PURCHASE #0680 GELSON'S MARKET PASADENA,-260.0,115915.0
685,Helen Troy,337,44,35,Apple Pay,,,,Health & Wellness,APPLE PAY PURCHASE #0791 24 HOUR FITNESS MEMBERSHIP,-360.0,115555.0
686,Helen Troy,338,45,35,Check,,,,Tax,CHECK #09876 PAYMENT TO CALIFORNIA STATE TAX BOARD,-10500.0,105055.0
687,Helen Troy,339,46,35,ACH,,,,Donations,ACH DEBIT MONTHLY DONATION TO NATIONAL COALITION AGAINST DOMESTIC VIOLENCE,-1600.0,103455.0
688,Helen Troy,340,47,35,Debit Card,,,,Travel,POS PURCHASE #0892 AMERICAN AIRLINES FLIGHT TO PARIS,-3200.0,100255.0
689,Helen Troy,341,48,35,Debit Card,,,,Shopping,POS PURCHASE #1903 BLOOMINGDALE'S GLENDALE,-800.0,99455.0
690,Helen Troy,342,49,35,Transfer,,,,Home,TRANSFER TO MORTGAGE PAYMENT BANK OF AMERICA HOME LOANS,-5000.0,94455.0
691,Helen Troy,343,50,35,Debit Card,,,,Food & drink,POS PURCHASE #2014 DIN TAI FUNG ARCADIA,-190.0,94265.0
692,Helen Troy,344,51,35,ACH,,,,Benefits,ACH CREDIT MODELLING AGENCY PAYMENT RECEIVED,5000.0,99265.0
693,Helen Troy,345,52,35,Google Wallet,,,,Entertainment,GOOGLE WALLET PURCHASE #2125 SPOTIFY PREMIUM SUBSCRIPTION,-105.0,99160.0
694,Helen Troy,346,53,35,Debit Card,,,,Food & drink,POS PURCHASE #2236 STARBUCKS PASADENA,-95.0,99065.0
695,Helen Troy,347,54,35,Transfer,,,,Investment,TRANSFER TO ROBINHOOD INVESTMENT ACCOUNT,-20000.0,79065.0
696,Helen Troy,348,55,35,Debit Card,,,,Shopping,POS PURCHASE #2347 BEST BUY PASADENA,-480.0,78585.0
697,Helen Troy,349,56,35,ACH,,,,Donations,ACH DEBIT MONTHLY DONATION TO AMERICAN RED CROSS,-2100.0,76485.0
698,Helen Troy,350,57,35,Debit Card,,,,Health & Wellness,POS PURCHASE #2458 WALGREENS PHARMACY ARCADIA,-110.0,76375.0
699,Helen Troy,351,58,35,PayPal,,,,Professional Services,PAYPAL PAYMENT TO JONES PUBLIC RELATIONS SERVICES,-550.0,75825.0
700,Helen Troy,352,59,35,Debit Card,,,,Food & drink,POS PURCHASE #2569 CHIPOTLE MEXICAN GRILL PASADENA,-140.0,75685.0
701,Helen Troy,353,60,35,Transfer,,,,Loan,TRANSFER TO CAR LOAN ACCOUNT PAYMENT,-1500.0,74185.0
702,Helen Troy,354,61,35,Debit Card,,,,Entertainment,POS PURCHASE #2670 DISNEYLAND PARK TICKETS,-270.0,73915.0
703,Helen Troy,355,62,35,Debit Card,,,,Travel,POS PURCHASE #2781 LYFT RIDE TO SAN FRANCISCO,-550.0,73365.0
704,Helen Troy,356,63,35,ACH,,,,Employment,ACH CREDIT CITY COUNCIL MONTHLY STIPEND,3000.0,76365.0
705,Helen Troy,357,64,35,Debit Card,,,,Shopping,POS PURCHASE #2892 HERMES BEVERLY HILLS,-1250.0,75115.0
706,Helen Troy,358,65,35,Debit Card,,,,Gas,POS PURCHASE #2903 SHELL GAS STATION ARCADIA,-85.0,75030.0
707,Helen Troy,359,66,35,Bill Pay,,,,Bills & utilities,BILL PAY AUTO DEBIT VERIZON WIRELESS PHONE BILL,-320.0,74710.0
708,Helen Troy,360,67,35,ACH,,,,Benefits,ACH CREDIT MODELLING AGENCY PAYMENT RECEIVED,5000.0,79710.0
709,Helen Troy,361,68,35,Credit Card,,,,Shopping,POS PURCHASE #3015 PRADA BEVERLY HILLS,-1850.0,77860.0
710,Helen Troy,362,69,35,Transfer,,,,Investment,TRANSFER TO MERRILL LYNCH INVESTMENT ACCOUNT,-20000.0,57860.0
711,Helen Troy,363,70,35,Bill Pay,,,,Bills & utilities,BILL PAY AUTO DEBIT CITY OF ARCADIA WATER BILL,-260.0,57600.0
712,Helen Troy,364,71,35,Debit Card,,,,Food & drink,POS PURCHASE #3126 PASADENA FARMERS MARKET,-115.0,57485.0
713,Helen Troy,365,72,35,Zelle,,,,Gift & Donations,INCOMING ZELLE FROM ROBERT KING FOR CHARITY AUCTION,2000.0,59485.0
714,Helen Troy,366,73,35,Wire,,,,Donations,OUTGOING WIRE TO DOMESTIC ABUSE FOUNDATION DONATION,-7000.0,52485.0
715,Helen Troy,367,74,35,ACH,,,,Employment,ACH CREDIT CITY COUNCIL MONTHLY STIPEND,3000.0,55485.0
716,Helen Troy,368,75,35,Debit Card,,,,Entertainment,POS PURCHASE #3237 ARCLIGHT CINEMAS PASADENA,-230.0,55255.0
717,Helen Troy,369,76,35,Debit Card,,,,Gas,POS PURCHASE #3348 TEXACO GAS STATION ARCADIA,-65.0,55190.0
718,Helen Troy,370,77,35,Transfer,,,,Home,TRANSFER TO MORTGAGE PAYMENT CITIBANK HOME LOANS,-5000.0,50190.0
719,Helen Troy,371,78,35,Debit Card,,,,Grocieries,POS PURCHASE #3459 WHOLE FOODS MARKET PASADENA,-275.0,49915.0
720,Helen Troy,372,79,35,Apple Pay,,,,Health & Wellness,APPLE PAY PURCHASE #3560 LA FITNESS MEMBERSHIP,-370.0,49545.0
721,Helen Troy,373,80,35,Check,,,,Tax,CHECK #40123 PAYMENT TO FRANCHISE TAX BOARD,-11000.0,38545.0
722,Helen Troy,374,81,35,ACH,,,,Donations,ACH DEBIT MONTHLY DONATION TO FEEDING AMERICA,-1700.0,36845.0
723,Helen Troy,375,82,35,Debit Card,,,,Travel,POS PURCHASE #3671 UNITED AIRLINES FLIGHT TO LONDON,-3400.0,33445.0
724,Helen Troy,376,83,35,Debit Card,,,,Shopping,POS PURCHASE #3782 SAKS FIFTH AVENUE GLENDALE,-850.0,32595.0
725,Helen Troy,377,84,35,Transfer,,,,Home,TRANSFER TO MORTGAGE PAYMENT SUNTRUST MORTGAGE,-5000.0,27595.0
726,Helen Troy,378,85,35,Debit Card,,,,Food & drink,POS PURCHASE #3893 NOBU MALIBU,-200.0,27395.0
727,Helen Troy,379,86,35,ACH,,,,Benefits,ACH CREDIT MODELLING AGENCY PAYMENT RECEIVED,5000.0,32395.0
728,Helen Troy,380,87,35,Google Wallet,,,,Entertainment,GOOGLE WALLET PURCHASE #3904 HULU MONTHLY SUBSCRIPTION,-110.0,32285.0
729,Helen Troy,381,88,35,Debit Card,,,,Food & drink,POS PURCHASE #4015 STARBUCKS PASADENA,-100.0,32185.0
730,Helen Troy,382,89,35,Transfer,,,,Investment,TRANSFER TO TD AMERITRADE INVESTMENT ACCOUNT,-20000.0,12185.0
731,Helen Troy,383,90,35,Debit Card,,,,Shopping,POS PURCHASE #4126 MICROSOFT STORE GLENDALE,-500.0,11685.0
732,Helen Troy,384,91,35,ACH,,,,Donations,ACH DEBIT MONTHLY DONATION TO ST JUDE CHILDREN'S RESEARCH HOSPITAL,-2200.0,9485.0
733,Helen Troy,385,92,35,Debit Card,,,,Health & Wellness,POS PURCHASE #4237 RITE AID PHARMACY ARCADIA,-120.0,9365.0
734,Helen Troy,386,93,35,PayPal,,,,Professional Services,PAYPAL PAYMENT TO CARTER LEGAL SERVICES,-600.0,8765.0
